prev_filename,filename,strType,xmin,ymin,xmax,ymax,labels,width,height,x_center,y_center,x_center_norm,y_center_norm,w_norm,h_norm
DJI_0164.JPG,0.jpg,ong_noi,1657,1346,2076,1466,0,419,120,1866,1406,0.46005917159763315,0.6166666666666667,0.10330374753451677,0.05263157894736842
DJI_0165.JPG,1.jpg,ong_noi,1748,1283,2460,1466,0,712,183,2104,1374,0.5187376725838264,0.6026315789473684,0.1755424063116371,0.08026315789473684
DJI_0166.JPG,2.jpg,ong_noi,1525,1226,2113,1326,0,588,100,1819,1276,0.4484714003944773,0.5596491228070175,0.14497041420118342,0.043859649122807015
DJI_0166.JPG,2.jpg,ong_noi,3542,1615,3682,1660,0,140,45,3612,1637,0.8905325443786982,0.7179824561403508,0.03451676528599606,0.019736842105263157
DJI_0167.JPG,3.jpg,ong_noi,1904,1484,2360,1679,0,456,195,2132,1581,0.5256410256410257,0.6934210526315789,0.11242603550295859,0.08552631578947369
DJI_0167.JPG,3.jpg,ong_noi,2709,1510,2824,1559,0,115,49,2766,1534,0.6819526627218935,0.6728070175438596,0.028353057199211044,0.02149122807017544
DJI_0168.JPG,4.jpg,ong_noi,1871,1110,2356,1299,0,485,189,2113,1204,0.520956607495069,0.5280701754385965,0.11957593688362919,0.08289473684210526
DJI_0168.JPG,4.jpg,ong_noi,3009,1772,3105,1843,0,96,71,3057,1807,0.753698224852071,0.7925438596491228,0.023668639053254437,0.031140350877192982
DJI_0169.JPG,5.jpg,ong_noi,1676,1042,2138,1252,0,462,210,1907,1147,0.47016765285996054,0.5030701754385964,0.11390532544378698,0.09210526315789473
DJI_0169.JPG,5.jpg,ong_noi,2820,1719,2905,1782,0,85,63,2862,1750,0.7056213017751479,0.7675438596491229,0.020956607495069033,0.02763157894736842
DJI_0169.JPG,5.jpg,ong_noi,2493,935,2588,977,0,95,42,2540,956,0.626232741617357,0.4192982456140351,0.02342209072978304,0.018421052631578946
DJI_0170.JPG,6.jpg,ong_noi,1471,1198,2004,1347,0,533,149,1737,1272,0.4282544378698225,0.5578947368421052,0.13141025641025642,0.06535087719298245
DJI_0170.JPG,6.jpg,ong_noi,3466,1144,3615,1187,0,149,43,3540,1165,0.8727810650887574,0.5109649122807017,0.03673570019723866,0.018859649122807017
DJI_0170.JPG,6.jpg,ong_noi,3676,2119,3840,2172,0,164,53,3758,2145,0.9265285996055227,0.9407894736842105,0.04043392504930966,0.02324561403508772
DJI_0171.JPG,7.jpg,ong_noi,1402,954,2198,1208,0,796,254,1800,1081,0.4437869822485207,0.47412280701754383,0.19625246548323472,0.11140350877192982
DJI_0171.JPG,7.jpg,ong_noi,3730,1140,3894,1181,0,164,41,3812,1160,0.9398422090729783,0.5087719298245614,0.04043392504930966,0.017982456140350878
DJI_0172.JPG,8.jpg,ong_noi,2042,816,2867,1057,0,825,241,2454,936,0.6050295857988166,0.4105263157894737,0.20340236686390534,0.10570175438596491
DJI_0172.JPG,8.jpg,ong_noi,3837,863,3973,909,0,136,46,3905,886,0.9627712031558185,0.38859649122807016,0.03353057199211045,0.02017543859649123
DJI_0173.JPG,9.jpg,ong_noi,1519,995,2351,1214,0,832,219,1935,1104,0.4770710059171598,0.4842105263157895,0.20512820512820512,0.09605263157894736
DJI_0174.JPG,10.jpg,ong_noi,1381,938,2273,1081,0,892,143,1827,1009,0.4504437869822485,0.4425438596491228,0.21992110453648916,0.06271929824561404
DJI_0175.JPG,11.jpg,ong_noi,1417,1118,2320,1244,0,903,126,1868,1181,0.46055226824457596,0.5179824561403509,0.22263313609467456,0.05526315789473684
DJI_0176.JPG,12.jpg,ong_noi,1643,1257,2457,1494,0,814,237,2050,1375,0.5054240631163708,0.6030701754385965,0.20069033530571992,0.10394736842105264
DJI_0177.JPG,13.jpg,ong_noi,1922,1059,2783,1427,0,861,368,2352,1243,0.5798816568047337,0.5451754385964912,0.21227810650887574,0.16140350877192983
DJI_0177.JPG,13.jpg,ong_noi,1753,2101,1926,2173,0,173,72,1839,2137,0.45340236686390534,0.9372807017543859,0.04265285996055227,0.031578947368421054
DJI_0178.JPG,14.jpg,ong_noi,1888,1107,2808,1505,0,920,398,2348,1306,0.5788954635108481,0.5728070175438597,0.22682445759368836,0.17456140350877192
DJI_0178.JPG,14.jpg,ong_noi,1884,2096,2053,2181,0,169,85,1968,2138,0.48520710059171596,0.9377192982456141,0.041666666666666664,0.03728070175438596
DJI_0179.JPG,15.jpg,ong_noi,1693,663,2331,1019,0,638,356,2012,841,0.4960552268244576,0.368859649122807,0.15729783037475345,0.156140350877193
DJI_0179.JPG,15.jpg,ong_noi,2158,2001,2301,2101,0,143,100,2229,2051,0.5495562130177515,0.8995614035087719,0.035256410256410256,0.043859649122807015
DJI_0180.JPG,16.jpg,ong_noi,1837,1059,2413,1423,0,576,364,2125,1241,0.5239151873767258,0.5442982456140351,0.14201183431952663,0.15964912280701754
DJI_0180.JPG,16.jpg,ong_noi,2176,2056,2330,2161,0,154,105,2253,2108,0.5554733727810651,0.9245614035087719,0.03796844181459566,0.046052631578947366
DJI_0181.JPG,17.jpg,ong_noi,1786,803,2485,1129,0,699,326,2135,966,0.5263806706114399,0.4236842105263158,0.17233727810650887,0.14298245614035088
DJI_0181.JPG,17.jpg,ong_noi,2179,2015,2335,2130,0,156,115,2257,2072,0.5564595660749507,0.9087719298245615,0.038461538461538464,0.05043859649122807
DJI_0182.JPG,18.jpg,ong_noi,1970,754,2546,1198,0,576,444,2258,976,0.5567061143984221,0.4280701754385965,0.14201183431952663,0.19473684210526315
DJI_0182.JPG,18.jpg,ong_noi,1918,476,2027,543,0,109,67,1972,509,0.48619329388560156,0.22324561403508772,0.02687376725838264,0.029385964912280703
DJI_0183.JPG,19.jpg,ong_noi,1965,328,2637,757,0,672,429,2301,542,0.5673076923076923,0.23771929824561402,0.16568047337278108,0.1881578947368421
DJI_0183.JPG,19.jpg,ong_noi,1913,425,2004,480,0,91,55,1958,452,0.482741617357002,0.19824561403508772,0.022435897435897436,0.02412280701754386
DJI_0184.JPG,20.jpg,ong_noi,1935,672,2282,959,0,347,287,2108,815,0.519723865877712,0.3574561403508772,0.08555226824457594,0.12587719298245614
DJI_0184.JPG,20.jpg,ong_noi,1907,478,2011,546,0,104,68,1959,512,0.48298816568047337,0.22456140350877193,0.02564102564102564,0.02982456140350877
DJI_0185.JPG,21.jpg,ong_noi,1996,1097,2327,1385,0,331,288,2161,1241,0.5327909270216963,0.5442982456140351,0.08160749506903353,0.12631578947368421
DJI_0185.JPG,21.jpg,ong_noi,1948,585,2043,649,0,95,64,1995,617,0.4918639053254438,0.2706140350877193,0.02342209072978304,0.028070175438596492
DJI_0186.JPG,22.jpg,ong_noi,1727,1086,2024,1380,0,297,294,1875,1233,0.46227810650887574,0.5407894736842105,0.07322485207100592,0.12894736842105264
DJI_0186.JPG,22.jpg,ong_noi,1890,587,1981,651,0,91,64,1935,619,0.4770710059171598,0.27149122807017545,0.022435897435897436,0.028070175438596492
DJI_0187.JPG,23.jpg,ong_noi,1637,887,1943,1242,0,306,355,1790,1064,0.4413214990138067,0.4666666666666667,0.07544378698224852,0.15570175438596492
DJI_0188.JPG,24.jpg,ong_noi,1930,720,2230,1091,0,300,371,2080,905,0.5128205128205128,0.3969298245614035,0.07396449704142012,0.16271929824561404
DJI_0189.JPG,25.jpg,ong_noi,2120,754,2250,1176,0,130,422,2185,965,0.5387080867850098,0.4232456140350877,0.03205128205128205,0.1850877192982456
DJI_0190.JPG,26.jpg,ong_noi,2035,680,2331,1198,0,296,518,2183,939,0.5382149901380671,0.4118421052631579,0.07297830374753451,0.22719298245614036
DJI_0191.JPG,27.jpg,ong_noi,2480,834,2849,1339,0,369,505,2664,1086,0.6568047337278107,0.4763157894736842,0.09097633136094675,0.22149122807017543
DJI_0192.JPG,28.jpg,ong_noi,2500,623,2826,1016,0,326,393,2663,819,0.6565581854043393,0.3592105263157895,0.08037475345167652,0.1723684210526316
DJI_0193.JPG,29.jpg,ong_noi,2316,892,2707,1293,0,391,401,2511,1092,0.6190828402366864,0.4789473684210526,0.09640039447731756,0.17587719298245613
DJI_0194.JPG,30.jpg,ong_noi,1759,972,2243,1419,0,484,447,2001,1195,0.4933431952662722,0.5241228070175439,0.11932938856015779,0.19605263157894737
DJI_0195.JPG,31.jpg,ong_noi,1807,875,2451,1289,0,644,414,2129,1082,0.5249013806706114,0.4745614035087719,0.15877712031558186,0.18157894736842106
DJI_0196.JPG,32.jpg,ong_noi,1582,997,2277,1293,0,695,296,1929,1145,0.4755917159763314,0.5021929824561403,0.17135108481262326,0.12982456140350876
DJI_0197.JPG,33.jpg,ong_noi,1902,983,2607,1189,0,705,206,2254,1086,0.5557199211045365,0.4763157894736842,0.17381656804733728,0.09035087719298246
DJI_0198.JPG,34.jpg,ong_noi,2352,1089,3115,1239,0,763,150,2733,1164,0.6738165680473372,0.5105263157894737,0.1881163708086785,0.06578947368421052
DJI_0199.JPG,35.jpg,ong_noi,1994,1163,2777,1360,0,783,197,2385,1261,0.5880177514792899,0.5530701754385965,0.1930473372781065,0.08640350877192983
DJI_0200.JPG,36.jpg,ong_noi,1698,1289,2611,1493,0,913,204,2154,1391,0.5310650887573964,0.6100877192982456,0.22509861932938857,0.08947368421052632
DJI_0201.JPG,37.jpg,ong_noi,1532,1285,2286,1547,0,754,262,1909,1416,0.47066074950690334,0.6210526315789474,0.1858974358974359,0.11491228070175438
DJI_0201.JPG,37.jpg,ong_noi,53,2104,210,2195,0,157,91,131,2149,0.03229783037475345,0.9425438596491228,0.038708086785009865,0.039912280701754385
DJI_0202.JPG,38.jpg,ong_noi,1673,1285,2444,1593,0,771,308,2058,1439,0.507396449704142,0.631140350877193,0.1900887573964497,0.13508771929824562
DJI_0202.JPG,38.jpg,ong_noi,189,2003,335,2096,0,146,93,262,2049,0.0645956607495069,0.8986842105263158,0.03599605522682446,0.04078947368421053
DJI_0203.JPG,39.jpg,ong_noi,1602,1268,2302,1672,0,700,404,1952,1470,0.4812623274161736,0.6447368421052632,0.17258382642998027,0.17719298245614035
DJI_0203.JPG,39.jpg,ong_noi,441,1780,568,1887,0,127,107,504,1833,0.1242603550295858,0.8039473684210526,0.03131163708086785,0.04692982456140351
DJI_0204.JPG,40.jpg,ong_noi,1688,1088,2241,1491,0,553,403,1964,1289,0.48422090729783035,0.5653508771929825,0.13634122287968442,0.17675438596491228
DJI_0204.JPG,40.jpg,ong_noi,478,1535,591,1628,0,113,93,534,1581,0.13165680473372782,0.6934210526315789,0.027859960552268245,0.04078947368421053
DJI_0205.JPG,41.jpg,ong_noi,1774,1083,2276,1575,0,502,492,2025,1329,0.4992603550295858,0.5828947368421052,0.12376725838264299,0.21578947368421053
DJI_0205.JPG,41.jpg,ong_noi,944,1254,1026,1366,0,82,112,985,1310,0.24285009861932938,0.5745614035087719,0.02021696252465483,0.04912280701754386
DJI_0206.JPG,42.jpg,ong_noi,1580,958,1885,1519,0,305,561,1732,1238,0.4270216962524655,0.5429824561403509,0.07519723865877712,0.24605263157894736
DJI_0206.JPG,42.jpg,ong_noi,409,958,452,1063,0,43,105,430,1010,0.10601577909270217,0.44298245614035087,0.010601577909270217,0.046052631578947366
DJI_0207.JPG,43.jpg,ong_noi,2014,958,2262,1527,0,248,569,2138,1242,0.527120315581854,0.5447368421052632,0.0611439842209073,0.24956140350877193
DJI_0207.JPG,43.jpg,ong_noi,860,777,898,902,0,38,125,879,839,0.21671597633136094,0.36798245614035086,0.009368836291913214,0.05482456140350877
DJI_0208.JPG,44.jpg,ong_noi,1839,1008,1996,1605,0,157,597,1917,1306,0.47263313609467456,0.5728070175438597,0.038708086785009865,0.2618421052631579
DJI_0208.JPG,44.jpg,ong_noi,1131,711,1184,809,0,53,98,1157,760,0.28525641025641024,0.3333333333333333,0.013067061143984222,0.04298245614035088
DJI_0209.JPG,45.jpg,ong_noi,1949,1048,2189,1646,0,240,598,2069,1347,0.5101084812623274,0.5907894736842105,0.05917159763313609,0.26228070175438595
DJI_0209.JPG,45.jpg,ong_noi,1581,635,1631,745,0,50,110,1606,690,0.39595660749506906,0.3026315789473684,0.01232741617357002,0.04824561403508772
DJI_0210.JPG,46.jpg,ong_noi,1590,1015,2136,1568,0,546,553,1863,1291,0.4593195266272189,0.5662280701754386,0.1346153846153846,0.2425438596491228
DJI_0210.JPG,46.jpg,ong_noi,2328,619,2410,704,0,82,85,2369,661,0.5840729783037475,0.2899122807017544,0.02021696252465483,0.03728070175438596
DJI_0211.JPG,47.jpg,ong_noi,1828,958,2384,1550,0,556,592,2106,1254,0.5192307692307693,0.55,0.13708086785009863,0.2596491228070175
DJI_0211.JPG,47.jpg,ong_noi,2549,640,2648,721,0,99,81,2598,680,0.6405325443786982,0.2982456140350877,0.02440828402366864,0.035526315789473684
DJI_0212.JPG,48.jpg,ong_noi,1869,844,2280,1196,0,411,352,2074,1020,0.5113412228796844,0.4473684210526316,0.10133136094674557,0.1543859649122807
DJI_0212.JPG,48.jpg,ong_noi,2504,640,2595,716,0,91,76,2549,678,0.6284516765285996,0.29736842105263156,0.022435897435897436,0.03333333333333333
DJI_0213.JPG,49.jpg,ong_noi,1728,811,2197,1101,0,469,290,1962,956,0.48372781065088755,0.4192982456140351,0.11563116370808678,0.12719298245614036
DJI_0213.JPG,49.jpg,ong_noi,2985,759,3123,829,0,138,70,3054,794,0.7529585798816568,0.3482456140350877,0.034023668639053255,0.03070175438596491
DJI_0213.JPG,49.jpg,ong_noi,3608,1689,3739,1781,0,131,92,3673,1735,0.9055719921104537,0.7609649122807017,0.03229783037475345,0.04035087719298246
DJI_0214.JPG,50.jpg,ong_noi,1932,972,2452,1141,0,520,169,2192,1056,0.5404339250493096,0.4631578947368421,0.1282051282051282,0.07412280701754385
DJI_0214.JPG,50.jpg,ong_noi,3837,1214,4001,1254,0,164,40,3919,1234,0.9662228796844181,0.5412280701754386,0.04043392504930966,0.017543859649122806
DJI_0214.JPG,50.jpg,ong_noi,3869,246,4013,290,0,144,44,3941,268,0.971646942800789,0.11754385964912281,0.03550295857988166,0.01929824561403509
DJI_0215.JPG,51.jpg,ong_noi,1800,1164,2314,1288,0,514,124,2057,1226,0.5071499013806706,0.537719298245614,0.1267258382642998,0.054385964912280704
DJI_0216.JPG,52.jpg,ong_noi,1780,1016,2719,1194,0,939,178,2249,1105,0.5544871794871795,0.48464912280701755,0.23150887573964496,0.0780701754385965
DJI_0217.JPG,53.jpg,ong_noi,1933,982,2915,1220,0,982,238,2424,1101,0.5976331360946746,0.48289473684210527,0.24211045364891517,0.10438596491228071
DJI_0218.JPG,54.jpg,ong_noi,1465,967,2493,1215,0,1028,248,1979,1091,0.4879191321499014,0.47850877192982455,0.2534516765285996,0.10877192982456141
DJI_0219.JPG,55.jpg,ong_noi,1608,933,2622,1228,0,1014,295,2115,1080,0.5214497041420119,0.47368421052631576,0.25,0.12938596491228072
DJI_0220.JPG,56.jpg,ong_noi,1552,935,2615,1339,0,1063,404,2083,1137,0.513560157790927,0.4986842105263158,0.2620808678500986,0.17719298245614035
DJI_0221.JPG,57.jpg,ong_noi,1626,1005,2668,1450,0,1042,445,2147,1227,0.5293392504930966,0.5381578947368421,0.2569033530571992,0.19517543859649122
DJI_0222.JPG,58.jpg,ong_noi,1710,1095,2671,1580,0,961,485,2190,1337,0.5399408284023669,0.5864035087719298,0.23693293885601577,0.21271929824561403
DJI_0223.JPG,59.jpg,ong_noi,1739,1144,2702,1757,0,963,613,2220,1450,0.5473372781065089,0.6359649122807017,0.23742603550295857,0.268859649122807
DJI_0224.JPG,60.jpg,ong_noi,1763,1133,2672,1770,0,909,637,2217,1451,0.5465976331360947,0.6364035087719299,0.22411242603550297,0.2793859649122807
DJI_0225.JPG,61.jpg,ong_noi,1478,815,2456,1607,0,978,792,1967,1211,0.4849605522682446,0.531140350877193,0.2411242603550296,0.3473684210526316
DJI_0226.JPG,62.jpg,ong_noi,1526,786,2451,1634,0,925,848,1988,1210,0.490138067061144,0.5307017543859649,0.22805719921104536,0.3719298245614035
DJI_0227.JPG,63.jpg,ong_noi,1688,673,2565,1580,0,877,907,2126,1126,0.5241617357001972,0.493859649122807,0.21622287968441814,0.39780701754385966
DJI_0227.JPG,63.jpg,ong_noi,2525,1323,2674,1462,0,149,139,2599,1392,0.6407790927021696,0.6105263157894737,0.03673570019723866,0.06096491228070176
DJI_0228.JPG,64.jpg,ong_noi,1943,1286,2765,2120,0,822,834,2354,1703,0.5803747534516766,0.7469298245614036,0.20266272189349113,0.36578947368421055
DJI_0228.JPG,64.jpg,ong_noi,2532,1383,2708,1554,0,176,171,2620,1468,0.645956607495069,0.643859649122807,0.04339250493096647,0.075
DJI_0229.JPG,65.jpg,ong_noi,2008,973,2540,1492,0,532,519,2274,1232,0.5606508875739645,0.5403508771929825,0.131163708086785,0.22763157894736843
DJI_0229.JPG,65.jpg,ong_noi,2516,1325,2668,1472,0,152,147,2592,1398,0.6390532544378699,0.6131578947368421,0.03747534516765286,0.06447368421052632
DJI_0230.JPG,66.jpg,ong_noi,2107,1001,2738,1436,0,631,435,2422,1218,0.5971400394477318,0.5342105263157895,0.15557199211045364,0.19078947368421054
DJI_0230.JPG,66.jpg,ong_noi,2276,1272,2428,1381,0,152,109,2352,1326,0.5798816568047337,0.5815789473684211,0.03747534516765286,0.04780701754385965
DJI_0231.JPG,67.jpg,ong_noi,1805,1019,2543,1366,0,738,347,2174,1192,0.5359960552268245,0.5228070175438596,0.1819526627218935,0.15219298245614035
DJI_0231.JPG,67.jpg,ong_noi,1875,1265,2047,1349,0,172,84,1961,1307,0.4834812623274162,0.5732456140350877,0.04240631163708087,0.03684210526315789
DJI_0232.JPG,68.jpg,ong_noi,1641,1033,2401,1319,0,760,286,2021,1176,0.4982741617357002,0.5157894736842106,0.1873767258382643,0.12543859649122807
DJI_0232.JPG,68.jpg,ong_noi,1649,1305,1785,1353,0,136,48,1717,1329,0.4233234714003945,0.5828947368421052,0.03353057199211045,0.021052631578947368
DJI_0233.JPG,69.jpg,ong_noi,1525,1050,2275,1289,0,750,239,1900,1169,0.46844181459566075,0.512719298245614,0.1849112426035503,0.10482456140350878
DJI_0233.JPG,69.jpg,ong_noi,1358,1347,1532,1416,0,174,69,1445,1381,0.3562623274161736,0.605701754385965,0.042899408284023666,0.030263157894736843
DJI_0234.JPG,70.jpg,ong_noi,1499,1133,2318,1280,0,819,147,1908,1206,0.47041420118343197,0.5289473684210526,0.20192307692307693,0.06447368421052632
DJI_0234.JPG,70.jpg,ong_noi,1150,1452,1326,1499,0,176,47,1238,1475,0.3052268244575937,0.6469298245614035,0.04339250493096647,0.0206140350877193
DJI_0235.JPG,71.jpg,ong_noi,1369,1142,2101,1327,0,732,185,1735,1234,0.4277613412228797,0.5412280701754386,0.1804733727810651,0.08114035087719298
DJI_0235.JPG,71.jpg,ong_noi,865,1585,1062,1637,0,197,52,963,1611,0.23742603550295857,0.7065789473684211,0.048570019723865876,0.02280701754385965
DJI_0236.JPG,72.jpg,ong_noi,1979,963,2741,1234,0,762,271,2360,1098,0.5818540433925049,0.48157894736842105,0.1878698224852071,0.11885964912280701
DJI_0236.JPG,72.jpg,ong_noi,709,1773,903,1841,0,194,68,806,1807,0.1987179487179487,0.7925438596491228,0.04783037475345168,0.02982456140350877
DJI_0236.JPG,72.jpg,ong_noi,3618,996,3783,1055,0,165,59,3700,1025,0.9122287968441815,0.44956140350877194,0.040680473372781065,0.02587719298245614
DJI_0237.JPG,73.jpg,ong_noi,1672,858,2366,1200,0,694,342,2019,1029,0.4977810650887574,0.4513157894736842,0.1711045364891519,0.15
DJI_0237.JPG,73.jpg,ong_noi,3800,1793,3936,1882,0,136,89,3868,1837,0.9536489151873767,0.8057017543859649,0.03353057199211045,0.03903508771929825
DJI_0237.JPG,73.jpg,ong_noi,329,2028,542,2139,0,213,111,435,2083,0.10724852071005918,0.9135964912280702,0.05251479289940828,0.04868421052631579
DJI_0237.JPG,73.jpg,ong_noi,3126,773,3241,834,0,115,61,3183,803,0.7847633136094675,0.35219298245614034,0.028353057199211044,0.02675438596491228
DJI_0239.JPG,74.jpg,ong_noi,1752,872,2072,1139,0,320,267,1912,1005,0.4714003944773176,0.4407894736842105,0.07889546351084813,0.11710526315789474
DJI_0239.JPG,74.jpg,ong_noi,3346,1498,3451,1588,0,105,90,3398,1543,0.8377712031558185,0.6767543859649123,0.025887573964497042,0.039473684210526314
DJI_0240.JPG,75.jpg,ong_noi,1592,885,1939,1162,0,347,277,1765,1023,0.43515779092702167,0.4486842105263158,0.08555226824457594,0.12149122807017544
DJI_0240.JPG,75.jpg,ong_noi,3722,712,3785,779,0,63,67,3753,745,0.9252958579881657,0.3267543859649123,0.015532544378698224,0.029385964912280703
DJI_0240.JPG,75.jpg,ong_noi,3106,1343,3212,1461,0,106,118,3159,1402,0.7788461538461539,0.6149122807017544,0.026134122287968443,0.05175438596491228
DJI_0240.JPG,75.jpg,ong_noi,2414,652,2498,725,0,84,73,2456,688,0.6055226824457594,0.3017543859649123,0.020710059171597635,0.032017543859649125
DJI_0241.JPG,76.jpg,ong_noi,1891,984,2376,1150,0,485,166,2133,1067,0.525887573964497,0.4679824561403509,0.11957593688362919,0.07280701754385965
DJI_0241.JPG,76.jpg,ong_noi,3493,1047,3654,1097,0,161,50,3573,1072,0.8809171597633136,0.47017543859649125,0.039694280078895465,0.021929824561403508
DJI_0241.JPG,76.jpg,ong_noi,849,1643,1033,1704,0,184,61,941,1673,0.23200197238658776,0.7337719298245614,0.045364891518737675,0.02675438596491228
DJI_0243.JPG,77.jpg,ong_noi,1495,1093,2020,1361,0,525,268,1757,1227,0.4331854043392505,0.5381578947368421,0.1294378698224852,0.11754385964912281
DJI_0244.JPG,78.jpg,ong_noi,1551,1022,1980,1343,0,429,321,1765,1182,0.43515779092702167,0.5184210526315789,0.10576923076923077,0.14078947368421052
DJI_0244.JPG,78.jpg,ong_noi,2103,1256,2247,1363,0,144,107,2175,1309,0.5362426035502958,0.5741228070175438,0.03550295857988166,0.04692982456140351
DJI_0246.JPG,79.jpg,ong_noi,1774,995,2031,1436,0,257,441,1902,1215,0.46893491124260356,0.5328947368421053,0.0633629191321499,0.19342105263157894
DJI_0246.JPG,79.jpg,ong_noi,2807,1462,2905,1615,0,98,153,2856,1538,0.7041420118343196,0.6745614035087719,0.024161735700197237,0.06710526315789474
DJI_0247.JPG,80.jpg,ong_noi,1843,800,2036,1097,0,193,297,1939,948,0.4780571992110454,0.41578947368421054,0.047583826429980276,0.13026315789473683
DJI_0247.JPG,80.jpg,ong_noi,2704,1332,2790,1465,0,86,133,2747,1398,0.6772682445759369,0.6131578947368421,0.021203155818540435,0.058333333333333334
DJI_0248.JPG,81.jpg,ong_noi,2101,811,2282,1136,0,181,325,2191,973,0.5401873767258383,0.4267543859649123,0.04462524654832347,0.1425438596491228
DJI_0248.JPG,81.jpg,ong_noi,2903,1406,2984,1549,0,81,143,2943,1477,0.7255917159763313,0.6478070175438596,0.019970414201183433,0.06271929824561404
DJI_0249.JPG,82.jpg,ong_noi,1729,855,1927,1131,0,198,276,1828,993,0.45069033530571995,0.4355263157894737,0.04881656804733728,0.12105263157894737
DJI_0249.JPG,82.jpg,ong_noi,2530,1292,2631,1422,0,101,130,2580,1357,0.636094674556213,0.5951754385964912,0.02490138067061144,0.05701754385964912
DJI_0250.JPG,83.jpg,ong_noi,1776,839,2033,1108,0,257,269,1904,973,0.46942800788954636,0.4267543859649123,0.0633629191321499,0.11798245614035088
DJI_0250.JPG,83.jpg,ong_noi,2343,1220,2468,1341,0,125,121,2405,1280,0.592948717948718,0.5614035087719298,0.03081854043392505,0.05307017543859649
DJI_0251.JPG,84.jpg,ong_noi,1574,847,1880,1109,0,306,262,1727,978,0.42578895463510846,0.42894736842105263,0.07544378698224852,0.11491228070175438
DJI_0251.JPG,84.jpg,ong_noi,2114,1192,2249,1300,0,135,108,2181,1246,0.5377218934911243,0.5464912280701755,0.03328402366863906,0.04736842105263158
DJI_0252.JPG,85.jpg,ong_noi,1878,864,2249,1047,0,371,183,2063,955,0.508629191321499,0.41885964912280704,0.09146942800788954,0.08026315789473684
DJI_0252.JPG,85.jpg,ong_noi,1940,1173,2090,1252,0,150,79,2015,1212,0.4967948717948718,0.531578947368421,0.03698224852071006,0.03464912280701754
DJI_0253.JPG,86.jpg,ong_noi,1824,878,2231,998,0,407,120,2027,938,0.4997534516765286,0.4114035087719298,0.10034516765285996,0.05263157894736842
DJI_0254.JPG,87.jpg,ong_noi,1960,747,2319,882,0,359,135,2139,814,0.5273668639053254,0.3570175438596491,0.08851084812623274,0.05921052631578947
DJI_0254.JPG,87.jpg,ong_noi,3660,1810,3799,1877,0,139,67,3729,1843,0.9193786982248521,0.8083333333333333,0.034270216962524656,0.029385964912280703
DJI_0254.JPG,87.jpg,ong_noi,925,1550,1108,1609,0,183,59,1016,1579,0.2504930966469428,0.6925438596491228,0.045118343195266274,0.02587719298245614
DJI_0254.JPG,87.jpg,ong_noi,3164,123,3297,165,0,133,42,3230,144,0.7963510848126233,0.06315789473684211,0.03279092702169625,0.018421052631578946
DJI_0254.JPG,87.jpg,ong_noi,3252,903,3396,954,0,144,51,3324,928,0.8195266272189349,0.4070175438596491,0.03550295857988166,0.02236842105263158
DJI_0255.JPG,88.jpg,ong_noi,1865,737,2142,927,0,277,190,2003,832,0.493836291913215,0.3649122807017544,0.06829388560157791,0.08333333333333333
DJI_0255.JPG,88.jpg,ong_noi,3179,1333,3281,1410,0,102,77,3230,1371,0.7963510848126233,0.6013157894736842,0.02514792899408284,0.033771929824561404
DJI_0255.JPG,88.jpg,ong_noi,3832,790,3898,861,0,66,71,3865,825,0.9529092702169625,0.3618421052631579,0.016272189349112426,0.031140350877192982
DJI_0256.JPG,89.jpg,ong_noi,1662,758,1876,1028,0,214,270,1769,893,0.4361439842209073,0.39166666666666666,0.05276134122287968,0.11842105263157894
DJI_0256.JPG,89.jpg,ong_noi,2592,1069,2647,1163,0,55,94,2619,1116,0.6457100591715976,0.48947368421052634,0.013560157790927022,0.0412280701754386
DJI_0256.JPG,89.jpg,ong_noi,2937,444,2991,523,0,54,79,2964,483,0.7307692307692307,0.2118421052631579,0.013313609467455622,0.03464912280701754
DJI_0257.JPG,90.jpg,ong_noi,1729,999,1964,1365,0,235,366,1846,1182,0.4551282051282051,0.5184210526315789,0.05793885601577909,0.16052631578947368
DJI_0257.JPG,90.jpg,ong_noi,2698,1155,2753,1277,0,55,122,2725,1216,0.671844181459566,0.5333333333333333,0.013560157790927022,0.05350877192982456
DJI_0257.JPG,90.jpg,ong_noi,3049,472,3099,554,0,50,82,3074,513,0.7578895463510849,0.225,0.01232741617357002,0.035964912280701755
DJI_0258.JPG,91.jpg,ong_noi,2047,997,2329,1340,0,282,343,2188,1168,0.539447731755424,0.512280701754386,0.0695266272189349,0.15043859649122807
DJI_0258.JPG,91.jpg,ong_noi,3051,1281,3134,1380,0,83,99,3092,1330,0.76232741617357,0.5833333333333334,0.020463510848126233,0.04342105263157895
DJI_0258.JPG,91.jpg,ong_noi,3541,623,3595,697,0,54,74,3568,660,0.8796844181459567,0.2894736842105263,0.013313609467455622,0.03245614035087719
DJI_0258.JPG,91.jpg,ong_noi,2310,653,2388,733,0,78,80,2349,693,0.5791420118343196,0.30394736842105263,0.019230769230769232,0.03508771929824561
DJI_0259.JPG,92.jpg,ong_noi,1943,1014,2305,1315,0,362,301,2124,1164,0.5236686390532544,0.5105263157894737,0.08925049309664694,0.13201754385964912
DJI_0259.JPG,92.jpg,ong_noi,3195,1373,3282,1465,0,87,92,3238,1419,0.7983234714003945,0.6223684210526316,0.021449704142011833,0.04035087719298246
DJI_0259.JPG,92.jpg,ong_noi,3768,719,3834,793,0,66,74,3801,756,0.9371301775147929,0.33157894736842103,0.016272189349112426,0.03245614035087719
DJI_0259.JPG,92.jpg,ong_noi,2475,663,2561,749,0,86,86,2518,706,0.6208086785009862,0.30964912280701756,0.021203155818540435,0.037719298245614034
DJI_0260.JPG,93.jpg,ong_noi,1867,1071,2254,1364,0,387,293,2060,1217,0.5078895463510849,0.5337719298245615,0.09541420118343195,0.12850877192982457
DJI_0260.JPG,93.jpg,ong_noi,3407,1562,3499,1644,0,92,82,3453,1603,0.8513313609467456,0.7030701754385965,0.022682445759368838,0.035964912280701755
DJI_0260.JPG,93.jpg,ong_noi,2753,749,2833,813,0,80,64,2793,781,0.6886094674556213,0.3425438596491228,0.01972386587771203,0.028070175438596492
DJI_0261.JPG,94.jpg,ong_noi,1823,1202,2223,1435,0,400,233,2023,1318,0.498767258382643,0.5780701754385965,0.09861932938856016,0.10219298245614035
DJI_0261.JPG,94.jpg,ong_noi,3621,1819,3736,1908,0,115,89,3678,1863,0.9068047337278107,0.8171052631578948,0.028353057199211044,0.03903508771929825
DJI_0261.JPG,94.jpg,ong_noi,2883,65,2994,125,0,111,60,2938,95,0.7243589743589743,0.041666666666666664,0.027366863905325445,0.02631578947368421
DJI_0261.JPG,94.jpg,ong_noi,551,1966,766,2055,0,215,89,658,2010,0.16222879684418146,0.881578947368421,0.053007889546351085,0.03903508771929825
DJI_0261.JPG,94.jpg,ong_noi,3043,881,3172,954,0,129,73,3107,917,0.7660256410256411,0.4021929824561403,0.031804733727810654,0.032017543859649125
DJI_0262.JPG,95.jpg,ong_noi,1914,1250,2369,1481,0,455,231,2141,1365,0.5278599605522682,0.5986842105263158,0.11217948717948718,0.1013157894736842
DJI_0262.JPG,95.jpg,ong_noi,3172,153,3325,202,0,153,49,3248,177,0.8007889546351085,0.07763157894736843,0.03772189349112426,0.02149122807017544
DJI_0262.JPG,95.jpg,ong_noi,3794,2015,3928,2095,0,134,80,3861,2055,0.9519230769230769,0.9013157894736842,0.033037475345167655,0.03508771929824561
DJI_0262.JPG,95.jpg,ong_noi,711,1843,926,1923,0,215,80,818,1883,0.20167652859960553,0.8258771929824561,0.053007889546351085,0.03508771929824561
DJI_0262.JPG,95.jpg,ong_noi,3302,989,3424,1056,0,122,67,3363,1022,0.8291420118343196,0.4482456140350877,0.03007889546351085,0.029385964912280703
DJI_0263.JPG,96.jpg,ong_noi,1946,1289,2468,1470,0,522,181,2207,1379,0.5441321499013807,0.6048245614035088,0.128698224852071,0.0793859649122807
DJI_0263.JPG,96.jpg,ong_noi,3379,231,3577,273,0,198,42,3478,252,0.8574950690335306,0.11052631578947368,0.04881656804733728,0.018421052631578946
DJI_0263.JPG,96.jpg,ong_noi,3902,2179,4048,2253,0,146,74,3975,2216,0.9800295857988166,0.9719298245614035,0.03599605522682446,0.03245614035087719
DJI_0263.JPG,96.jpg,ong_noi,829,1765,1024,1827,0,195,62,926,1796,0.22830374753451677,0.787719298245614,0.04807692307692308,0.027192982456140352
DJI_0263.JPG,96.jpg,ong_noi,3469,1093,3624,1145,0,155,52,3546,1119,0.8742603550295858,0.49078947368421055,0.03821499013806706,0.02280701754385965
DJI_0264.JPG,97.jpg,ong_noi,1744,1330,2240,1482,0,496,152,1992,1406,0.4911242603550296,0.6166666666666667,0.1222879684418146,0.06666666666666667
DJI_0264.JPG,97.jpg,ong_noi,3449,283,3678,325,0,229,42,3563,304,0.8784516765285996,0.13333333333333333,0.05645956607495069,0.018421052631578946
DJI_0264.JPG,97.jpg,ong_noi,853,1728,1019,1782,0,166,54,936,1755,0.23076923076923078,0.7697368421052632,0.040927021696252466,0.02368421052631579
DJI_0264.JPG,97.jpg,ong_noi,3514,1161,3691,1213,0,177,52,3602,1187,0.8880670611439843,0.5206140350877193,0.04363905325443787,0.02280701754385965
DJI_0265.JPG,98.jpg,ong_noi,1769,1312,2370,1451,0,601,139,2069,1381,0.5101084812623274,0.605701754385965,0.14817554240631164,0.06096491228070176
DJI_0265.JPG,98.jpg,ong_noi,3750,373,3951,424,0,201,51,3850,398,0.9492110453648915,0.17456140350877192,0.04955621301775148,0.02236842105263158
DJI_0265.JPG,98.jpg,ong_noi,987,1630,1152,1682,0,165,52,1069,1656,0.263560157790927,0.7263157894736842,0.040680473372781065,0.02280701754385965
DJI_0265.JPG,98.jpg,ong_noi,3757,1291,3910,1333,0,153,42,3833,1312,0.9450197238658777,0.5754385964912281,0.03772189349112426,0.018421052631578946
DJI_0266.JPG,99.jpg,ong_noi,1928,1385,2477,1478,0,549,93,2202,1431,0.5428994082840237,0.6276315789473684,0.13535502958579881,0.04078947368421053
DJI_0266.JPG,99.jpg,ong_noi,1165,1572,1330,1622,0,165,50,1247,1597,0.3074457593688363,0.7004385964912281,0.040680473372781065,0.021929824561403508
DJI_0267.JPG,100.jpg,ong_noi,2099,1130,2610,1235,0,511,105,2354,1182,0.5803747534516766,0.5184210526315789,0.1259861932938856,0.046052631578947366
DJI_0267.JPG,100.jpg,ong_noi,1310,1445,1499,1504,0,189,59,1404,1474,0.34615384615384615,0.6464912280701754,0.04659763313609468,0.02587719298245614
DJI_0268.JPG,101.jpg,ong_noi,2052,1151,2565,1288,0,513,137,2308,1219,0.5690335305719921,0.5346491228070176,0.1264792899408284,0.060087719298245613
DJI_0268.JPG,101.jpg,ong_noi,1464,1373,1643,1426,0,179,53,1553,1399,0.3828895463510848,0.6135964912280701,0.044132149901380674,0.02324561403508772
DJI_0269.JPG,102.jpg,ong_noi,2069,1173,2623,1325,0,554,152,2346,1249,0.5784023668639053,0.5478070175438596,0.13658777120315582,0.06666666666666667
DJI_0269.JPG,102.jpg,ong_noi,1564,1364,1723,1403,0,159,39,1643,1383,0.40507889546351084,0.6065789473684211,0.03920118343195266,0.017105263157894738
DJI_0270.JPG,103.jpg,ong_noi,2030,1238,2583,1420,0,553,182,2306,1329,0.5685404339250493,0.5828947368421052,0.13634122287968442,0.07982456140350877
DJI_0270.JPG,103.jpg,ong_noi,1725,1323,1917,1395,0,192,72,1821,1359,0.4489644970414201,0.5960526315789474,0.047337278106508875,0.031578947368421054
DJI_0271.JPG,104.jpg,ong_noi,1848,1263,2400,1526,0,552,263,2124,1394,0.5236686390532544,0.6114035087719298,0.13609467455621302,0.11535087719298245
DJI_0271.JPG,104.jpg,ong_noi,1863,1318,1991,1396,0,128,78,1927,1357,0.47509861932938857,0.5951754385964912,0.03155818540433925,0.034210526315789476
DJI_0272.JPG,105.jpg,ong_noi,1865,1230,2435,1489,0,570,259,2150,1359,0.5300788954635108,0.5960526315789474,0.14053254437869822,0.11359649122807018
DJI_0272.JPG,105.jpg,ong_noi,1879,1311,2017,1389,0,138,78,1948,1350,0.480276134122288,0.5921052631578947,0.034023668639053255,0.034210526315789476
DJI_0273.JPG,106.jpg,ong_noi,2082,1080,2664,1379,0,582,299,2373,1229,0.5850591715976331,0.5390350877192982,0.14349112426035504,0.13114035087719297
DJI_0273.JPG,106.jpg,ong_noi,2060,1267,2200,1344,0,140,77,2130,1305,0.5251479289940828,0.5723684210526315,0.03451676528599606,0.033771929824561404
DJI_0274.JPG,107.jpg,ong_noi,1646,1129,2231,1380,0,585,251,1938,1254,0.47781065088757396,0.55,0.14423076923076922,0.11008771929824561
DJI_0274.JPG,107.jpg,ong_noi,1819,1283,1978,1350,0,159,67,1898,1316,0.46794871794871795,0.5771929824561404,0.03920118343195266,0.029385964912280703
DJI_0275.JPG,108.jpg,ong_noi,1586,1189,2215,1356,0,629,167,1900,1272,0.46844181459566075,0.5578947368421052,0.15507889546351084,0.07324561403508772
DJI_0275.JPG,108.jpg,ong_noi,1521,1328,1748,1399,0,227,71,1634,1363,0.40285996055226825,0.5978070175438597,0.05596646942800789,0.031140350877192982
DJI_0276.JPG,109.jpg,ong_noi,1572,1238,2184,1355,0,612,117,1878,1296,0.4630177514792899,0.5684210526315789,0.15088757396449703,0.05131578947368421
DJI_0276.JPG,109.jpg,ong_noi,1327,1404,1535,1457,0,208,53,1431,1430,0.35281065088757396,0.6271929824561403,0.05128205128205128,0.02324561403508772
DJI_0277.JPG,110.jpg,ong_noi,1783,1105,2326,1218,0,543,113,2054,1161,0.5064102564102564,0.5092105263157894,0.1338757396449704,0.04956140350877193
DJI_0277.JPG,110.jpg,ong_noi,950,1621,1117,1661,0,167,40,1033,1641,0.2546844181459566,0.7197368421052631,0.04117357001972387,0.017543859649122806
DJI_0277.JPG,110.jpg,ong_noi,3665,1183,3833,1243,0,168,60,3749,1213,0.9243096646942801,0.5320175438596492,0.04142011834319527,0.02631578947368421
DJI_0278.JPG,111.jpg,ong_noi,1425,1113,1956,1390,0,531,277,1690,1251,0.4166666666666667,0.5486842105263158,0.1309171597633136,0.12149122807017544
DJI_0278.JPG,111.jpg,ong_noi,346,2069,549,2173,0,203,104,447,2121,0.11020710059171597,0.9302631578947368,0.05004930966469428,0.0456140350877193
DJI_0278.JPG,111.jpg,ong_noi,3431,1663,3565,1772,0,134,109,3498,1717,0.8624260355029586,0.7530701754385964,0.033037475345167655,0.04780701754385965
DJI_0279.JPG,112.jpg,ong_noi,1746,949,2062,1270,0,316,321,1904,1109,0.46942800788954636,0.48640350877192984,0.07790927021696252,0.14078947368421052
DJI_0279.JPG,112.jpg,ong_noi,2379,636,2450,712,0,71,76,2414,674,0.5951676528599605,0.2956140350877193,0.017504930966469427,0.03333333333333333
DJI_0279.JPG,112.jpg,ong_noi,3109,1316,3200,1439,0,91,123,3154,1377,0.7776134122287969,0.6039473684210527,0.022435897435897436,0.05394736842105263
DJI_0281.JPG,113.jpg,ong_noi,1454,905,1982,1379,0,528,474,1718,1142,0.4235700197238659,0.5008771929824561,0.1301775147928994,0.20789473684210527
DJI_0281.JPG,113.jpg,ong_noi,2411,618,2535,717,0,124,99,2473,667,0.6097140039447732,0.29254385964912283,0.03057199211045365,0.04342105263157895
DJI_0281.JPG,113.jpg,ong_noi,3204,1373,3310,1482,0,106,109,3257,1427,0.803007889546351,0.6258771929824561,0.026134122287968443,0.04780701754385965
DJI_0281.JPG,113.jpg,ong_noi,3801,665,3912,757,0,111,92,3856,711,0.9506903353057199,0.3118421052631579,0.027366863905325445,0.04035087719298246
DJI_0282.JPG,114.jpg,ong_noi,1539,944,2125,1401,0,586,457,1832,1172,0.4516765285996055,0.5140350877192983,0.14447731755424062,0.20043859649122808
DJI_0282.JPG,114.jpg,ong_noi,2623,652,2761,755,0,138,103,2692,703,0.6637080867850098,0.30833333333333335,0.034023668639053255,0.04517543859649123
DJI_0282.JPG,114.jpg,ong_noi,3396,1496,3502,1606,0,106,110,3449,1551,0.85034516765286,0.6802631578947368,0.026134122287968443,0.04824561403508772
DJI_0283.JPG,115.jpg,ong_noi,1524,988,2138,1418,0,614,430,1831,1203,0.4514299802761341,0.5276315789473685,0.15138067061143984,0.18859649122807018
DJI_0283.JPG,115.jpg,ong_noi,3655,1735,3781,1833,0,126,98,3718,1784,0.9166666666666666,0.7824561403508772,0.03106508875739645,0.04298245614035088
DJI_0283.JPG,115.jpg,ong_noi,2958,764,3092,834,0,134,70,3025,799,0.7458086785009862,0.35043859649122805,0.033037475345167655,0.03070175438596491
DJI_0284.JPG,116.jpg,ong_noi,1592,1079,2264,1424,0,672,345,1928,1251,0.47534516765285995,0.5486842105263158,0.16568047337278108,0.1513157894736842
DJI_0284.JPG,116.jpg,ong_noi,3849,1947,3988,2054,0,139,107,3918,2000,0.9659763313609467,0.8771929824561403,0.034270216962524656,0.04692982456140351
DJI_0284.JPG,116.jpg,ong_noi,3243,874,3375,947,0,132,73,3309,910,0.8158284023668639,0.3991228070175439,0.03254437869822485,0.032017543859649125
DJI_0284.JPG,116.jpg,ong_noi,422,1950,635,2042,0,213,92,528,1996,0.1301775147928994,0.875438596491228,0.05251479289940828,0.04035087719298246
DJI_0285.JPG,117.jpg,ong_noi,1801,1099,2481,1303,0,680,204,2141,1201,0.5278599605522682,0.5267543859649123,0.16765285996055226,0.08947368421052632
DJI_0285.JPG,117.jpg,ong_noi,703,1736,934,1812,0,231,76,818,1774,0.20167652859960553,0.7780701754385965,0.05695266272189349,0.03333333333333333
DJI_0285.JPG,117.jpg,ong_noi,3648,1084,3830,1138,0,182,54,3739,1111,0.921844181459566,0.487280701754386,0.04487179487179487,0.02368421052631579
DJI_0285.JPG,117.jpg,ong_noi,3636,93,3797,154,0,161,61,3716,123,0.9161735700197239,0.05394736842105263,0.039694280078895465,0.02675438596491228
DJI_0286.JPG,118.jpg,ong_noi,2104,1209,2888,1352,0,784,143,2496,1280,0.6153846153846154,0.5614035087719298,0.1932938856015779,0.06271929824561404
DJI_0286.JPG,118.jpg,ong_noi,1104,1536,1288,1611,0,184,75,1196,1573,0.2948717948717949,0.6899122807017544,0.045364891518737675,0.03289473684210526
DJI_0287.JPG,119.jpg,ong_noi,1885,1326,2712,1494,0,827,168,2298,1410,0.5665680473372781,0.618421052631579,0.2038954635108481,0.07368421052631578
DJI_0287.JPG,119.jpg,ong_noi,1146,1514,1368,1579,0,222,65,1257,1546,0.3099112426035503,0.6780701754385965,0.05473372781065089,0.02850877192982456
DJI_0288.JPG,120.jpg,ong_noi,1839,1408,2627,1581,0,788,173,2233,1494,0.5505424063116371,0.6552631578947369,0.1942800788954635,0.07587719298245614
DJI_0288.JPG,120.jpg,ong_noi,1344,1454,1555,1507,0,211,53,1449,1480,0.3572485207100592,0.6491228070175439,0.052021696252465485,0.02324561403508772
DJI_0289.JPG,121.jpg,ong_noi,1895,1177,2701,1377,0,806,200,2298,1277,0.5665680473372781,0.5600877192982456,0.1987179487179487,0.08771929824561403
DJI_0289.JPG,121.jpg,ong_noi,1355,1177,1544,1234,0,189,57,1449,1205,0.3572485207100592,0.5285087719298246,0.04659763313609468,0.025
DJI_0290.JPG,122.jpg,ong_noi,1973,1171,2750,1424,0,777,253,2361,1297,0.5821005917159763,0.5688596491228071,0.1915680473372781,0.11096491228070175
DJI_0291.JPG,123.jpg,ong_noi,1499,1081,2240,1434,0,741,353,1869,1257,0.46079881656804733,0.5513157894736842,0.18269230769230768,0.15482456140350878
DJI_0291.JPG,123.jpg,ong_noi,1754,1046,1915,1126,0,161,80,1834,1086,0.4521696252465483,0.4763157894736842,0.039694280078895465,0.03508771929824561
DJI_0292.JPG,124.jpg,ong_noi,1609,1015,2314,1447,0,705,432,1961,1231,0.4834812623274162,0.5399122807017543,0.17381656804733728,0.18947368421052632
DJI_0292.JPG,124.jpg,ong_noi,1966,1038,2123,1127,0,157,89,2044,1082,0.5039447731755424,0.4745614035087719,0.038708086785009865,0.03903508771929825
DJI_0293.JPG,125.jpg,ong_noi,1736,968,2420,1508,0,684,540,2078,1238,0.51232741617357,0.5429824561403509,0.16863905325443787,0.23684210526315788
DJI_0293.JPG,125.jpg,ong_noi,2221,1039,2352,1149,0,131,110,2286,1094,0.5636094674556213,0.47982456140350876,0.03229783037475345,0.04824561403508772
DJI_0294.JPG,126.jpg,ong_noi,1900,955,2504,1496,0,604,541,2202,1225,0.5428994082840237,0.5372807017543859,0.14891518737672585,0.23728070175438595
DJI_0294.JPG,126.jpg,ong_noi,2360,1058,2502,1181,0,142,123,2431,1119,0.5993589743589743,0.49078947368421055,0.035009861932938854,0.05394736842105263
DJI_0295.JPG,127.jpg,ong_noi,1951,889,2546,1478,0,595,589,2248,1183,0.5542406311637081,0.518859649122807,0.14669625246548323,0.25833333333333336
DJI_0295.JPG,127.jpg,ong_noi,2447,1060,2592,1197,0,145,137,2519,1128,0.6210552268244576,0.49473684210526314,0.03574950690335306,0.060087719298245613
DJI_0296.JPG,128.jpg,ong_noi,1962,870,2528,1472,0,566,602,2245,1171,0.5535009861932939,0.5135964912280702,0.13954635108481261,0.26403508771929823
DJI_0296.JPG,128.jpg,ong_noi,2531,1091,2667,1216,0,136,125,2599,1153,0.6407790927021696,0.5057017543859649,0.03353057199211045,0.05482456140350877
DJI_0297.JPG,129.jpg,ong_noi,1926,938,2443,1641,0,517,703,2184,1289,0.5384615384615384,0.5653508771929825,0.12746548323471402,0.30833333333333335
DJI_0297.JPG,129.jpg,ong_noi,2666,1150,2787,1293,0,121,143,2726,1221,0.6720907297830375,0.5355263157894737,0.029832347140039447,0.06271929824561404
DJI_0298.JPG,130.jpg,ong_noi,2206,1124,2620,1854,0,414,730,2413,1489,0.5949211045364892,0.6530701754385965,0.10207100591715976,0.3201754385964912
DJI_0298.JPG,130.jpg,ong_noi,2902,1270,3013,1431,0,111,161,2957,1350,0.729043392504931,0.5921052631578947,0.027366863905325445,0.0706140350877193
DJI_0299.JPG,131.jpg,ong_noi,2332,643,2711,1219,0,379,576,2521,931,0.6215483234714004,0.4083333333333333,0.09344181459566075,0.25263157894736843
DJI_0299.JPG,131.jpg,ong_noi,2910,1152,3031,1321,0,121,169,2970,1236,0.7322485207100592,0.5421052631578948,0.029832347140039447,0.07412280701754385
DJI_0300.JPG,132.jpg,ong_noi,2085,703,2397,1333,0,312,630,2241,1018,0.5525147928994083,0.44649122807017544,0.07692307692307693,0.27631578947368424
DJI_0300.JPG,132.jpg,ong_noi,2947,1213,3077,1413,0,130,200,3012,1313,0.742603550295858,0.5758771929824561,0.03205128205128205,0.08771929824561403
DJI_0302.JPG,133.jpg,ong_noi,2309,870,2508,1601,0,199,731,2408,1235,0.5936883629191322,0.5416666666666666,0.04906311637080868,0.3206140350877193
DJI_0302.JPG,133.jpg,ong_noi,3269,1451,3346,1628,0,77,177,3307,1539,0.8153353057199211,0.675,0.01898422090729783,0.07763157894736843
DJI_0303.JPG,134.jpg,ong_noi,2451,995,2610,1685,0,159,690,2530,1340,0.623767258382643,0.5877192982456141,0.03920118343195266,0.3026315789473684
DJI_0303.JPG,134.jpg,ong_noi,3490,1649,3571,1876,0,81,227,3530,1762,0.8703155818540433,0.7728070175438596,0.019970414201183433,0.09956140350877193
DJI_0304.JPG,135.jpg,ong_noi,2530,1115,2709,1824,0,179,709,2619,1469,0.6457100591715976,0.644298245614035,0.044132149901380674,0.3109649122807018
DJI_0304.JPG,135.jpg,ong_noi,3549,1708,3649,1941,0,100,233,3599,1824,0.88732741617357,0.8,0.02465483234714004,0.10219298245614035
DJI_0305.JPG,136.jpg,ong_noi,2470,863,2633,1414,0,163,551,2551,1138,0.6289447731755424,0.49912280701754386,0.04018737672583826,0.24166666666666667
DJI_0305.JPG,136.jpg,ong_noi,3548,1650,3628,1885,0,80,235,3588,1767,0.8846153846153846,0.775,0.01972386587771203,0.10307017543859649
DJI_0306.JPG,137.jpg,ong_noi,2503,898,2659,1478,0,156,580,2581,1188,0.6363412228796844,0.5210526315789473,0.038461538461538464,0.2543859649122807
DJI_0306.JPG,137.jpg,ong_noi,3632,1742,3723,1982,0,91,240,3677,1862,0.9065581854043393,0.8166666666666667,0.022435897435897436,0.10526315789473684
DJI_0307.JPG,138.jpg,ong_noi,2468,930,2626,1490,0,158,560,2547,1210,0.6279585798816568,0.5307017543859649,0.03895463510848126,0.24561403508771928
DJI_0307.JPG,138.jpg,ong_noi,3713,1880,3793,2071,0,80,191,3753,1975,0.9252958579881657,0.8662280701754386,0.01972386587771203,0.0837719298245614
DJI_0308.JPG,139.jpg,ong_noi,2423,872,2686,1610,0,263,738,2554,1241,0.6296844181459567,0.5442982456140351,0.0648422090729783,0.3236842105263158
DJI_0308.JPG,139.jpg,ong_noi,3757,1951,3827,2152,0,70,201,3792,2051,0.9349112426035503,0.8995614035087719,0.01725838264299803,0.0881578947368421
DJI_0309.JPG,140.jpg,ong_noi,2527,1000,2742,1646,0,215,646,2634,1323,0.6494082840236687,0.5802631578947368,0.053007889546351085,0.2833333333333333
DJI_0310.JPG,141.jpg,ong_noi,2208,1054,2513,1636,0,305,582,2360,1345,0.5818540433925049,0.5899122807017544,0.07519723865877712,0.25526315789473686
DJI_0311.JPG,142.jpg,ong_noi,2052,1086,2406,1709,0,354,623,2229,1397,0.5495562130177515,0.612719298245614,0.08727810650887574,0.27324561403508774
DJI_0312.JPG,143.jpg,ong_noi,2041,1072,2422,1724,0,381,652,2231,1398,0.5500493096646942,0.6131578947368421,0.09393491124260354,0.28596491228070176
DJI_0313.JPG,144.jpg,ong_noi,2153,1103,2565,1691,0,412,588,2359,1397,0.5816074950690335,0.612719298245614,0.10157790927021697,0.2578947368421053
DJI_0314.JPG,145.jpg,ong_noi,2101,1076,2610,1639,0,509,563,2355,1357,0.5806213017751479,0.5951754385964912,0.1254930966469428,0.2469298245614035
DJI_0315.JPG,146.jpg,ong_noi,1846,1086,2369,1636,0,523,550,2107,1361,0.5194773175542406,0.5969298245614035,0.1289447731755424,0.2412280701754386
DJI_0316.JPG,147.jpg,ong_noi,1723,1132,2315,1705,0,592,573,2019,1418,0.4977810650887574,0.6219298245614036,0.14595660749506903,0.2513157894736842
DJI_0317.JPG,148.jpg,ong_noi,1707,1198,2369,1683,0,662,485,2038,1440,0.502465483234714,0.631578947368421,0.16321499013806706,0.21271929824561403
DJI_0318.JPG,149.jpg,ong_noi,1822,1215,2461,1604,0,639,389,2141,1409,0.5278599605522682,0.6179824561403509,0.15754437869822485,0.1706140350877193
DJI_0320.JPG,150.jpg,ong_noi,1834,1319,2615,1645,0,781,326,2224,1482,0.5483234714003945,0.65,0.19255424063116372,0.14298245614035088
DJI_0321.JPG,151.jpg,ong_noi,1741,1433,2569,1670,0,828,237,2155,1551,0.5313116370808678,0.6802631578947368,0.20414201183431951,0.10394736842105264
DJI_0322.JPG,152.jpg,ong_noi,1708,1505,2560,1695,0,852,190,2134,1600,0.5261341222879684,0.7017543859649122,0.21005917159763313,0.08333333333333333
DJI_0323.JPG,153.jpg,ong_noi,1801,1597,2654,1753,0,853,156,2227,1675,0.5490631163708086,0.7346491228070176,0.21030571992110453,0.06842105263157895
DJI_0324.JPG,154.jpg,ong_noi,1969,1207,2772,1302,0,803,95,2370,1254,0.584319526627219,0.55,0.19797830374753453,0.041666666666666664
DJI_0325.JPG,155.jpg,ong_noi,1914,1158,2903,1277,0,989,119,2408,1217,0.5936883629191322,0.5337719298245615,0.243836291913215,0.052192982456140354
DJI_0326.JPG,156.jpg,ong_noi,1648,1089,2544,1377,0,896,288,2096,1233,0.5167652859960552,0.5407894736842105,0.22090729783037474,0.12631578947368421
DJI_0327.JPG,157.jpg,ong_noi,1479,1079,2430,1347,0,951,268,1954,1213,0.4817554240631164,0.5320175438596492,0.23446745562130178,0.11754385964912281
DJI_0328.JPG,158.jpg,ong_noi,1735,976,2583,1411,0,848,435,2159,1193,0.5322978303747534,0.5232456140350877,0.20907297830374755,0.19078947368421054
DJI_0329.JPG,159.jpg,ong_noi,1815,902,2498,1222,0,683,320,2156,1062,0.5315581854043393,0.46578947368421053,0.16839250493096647,0.14035087719298245
DJI_0329.JPG,159.jpg,ong_noi,368,1150,556,1259,0,188,109,462,1204,0.11390532544378698,0.5280701754385965,0.046351084812623275,0.04780701754385965
DJI_0330.JPG,160.jpg,ong_noi,1917,930,2522,1250,0,605,320,2219,1090,0.5470907297830375,0.4780701754385965,0.14916173570019725,0.14035087719298245
DJI_0330.JPG,160.jpg,ong_noi,484,1094,633,1192,0,149,98,558,1143,0.13757396449704143,0.5013157894736842,0.03673570019723866,0.04298245614035088
DJI_0331.JPG,161.jpg,ong_noi,2035,947,2694,1310,0,659,363,2364,1128,0.5828402366863905,0.49473684210526314,0.16247534516765286,0.15921052631578947
DJI_0331.JPG,161.jpg,ong_noi,546,1045,692,1150,0,146,105,619,1097,0.15261341222879685,0.481140350877193,0.03599605522682446,0.046052631578947366
DJI_0332.JPG,162.jpg,ong_noi,1788,891,2374,1346,0,586,455,2081,1118,0.5130670611439843,0.4903508771929825,0.14447731755424062,0.19956140350877194
DJI_0332.JPG,162.jpg,ong_noi,703,895,818,998,0,115,103,760,946,0.1873767258382643,0.4149122807017544,0.028353057199211044,0.04517543859649123
DJI_0333.JPG,163.jpg,ong_noi,1977,943,2445,1401,0,468,458,2211,1172,0.5451183431952663,0.5140350877192983,0.11538461538461539,0.20087719298245615
DJI_0333.JPG,163.jpg,ong_noi,938,772,1050,901,0,112,129,994,836,0.245069033530572,0.36666666666666664,0.027613412228796843,0.056578947368421055
DJI_0334.JPG,164.jpg,ong_noi,2012,922,2469,1461,0,457,539,2240,1191,0.5522682445759369,0.5223684210526316,0.11267258382642999,0.23640350877192984
DJI_0334.JPG,164.jpg,ong_noi,1109,684,1201,813,0,92,129,1155,748,0.28476331360946744,0.3280701754385965,0.022682445759368838,0.056578947368421055
DJI_0335.JPG,165.jpg,ong_noi,1855,964,2224,1511,0,369,547,2039,1237,0.5027120315581854,0.5425438596491228,0.09097633136094675,0.23991228070175438
DJI_0335.JPG,165.jpg,ong_noi,1202,631,1288,775,0,86,144,1245,703,0.3069526627218935,0.30833333333333335,0.021203155818540435,0.06315789473684211
DJI_0336.JPG,166.jpg,ong_noi,1952,984,2296,1641,0,344,657,2124,1312,0.5236686390532544,0.5754385964912281,0.08481262327416174,0.2881578947368421
DJI_0336.JPG,166.jpg,ong_noi,1412,583,1480,725,0,68,142,1446,654,0.35650887573964496,0.2868421052631579,0.016765285996055226,0.062280701754385964
DJI_0337.JPG,167.jpg,ong_noi,2083,1050,2360,1713,0,277,663,2221,1381,0.5475838264299803,0.605701754385965,0.06829388560157791,0.29078947368421054
DJI_0337.JPG,167.jpg,ong_noi,1602,539,1663,708,0,61,169,1632,623,0.40236686390532544,0.27324561403508774,0.015039447731755425,0.07412280701754385
DJI_0338.JPG,168.jpg,ong_noi,2172,1133,2406,1843,0,234,710,2289,1488,0.5643491124260355,0.6526315789473685,0.057692307692307696,0.31140350877192985
DJI_0338.JPG,168.jpg,ong_noi,604,441,657,563,0,53,122,630,502,0.15532544378698224,0.22017543859649122,0.013067061143984222,0.05350877192982456
DJI_0338.JPG,168.jpg,ong_noi,1793,530,1846,687,0,53,157,1819,608,0.4484714003944773,0.26666666666666666,0.013067061143984222,0.06885964912280702
DJI_0339.JPG,169.jpg,ong_noi,2224,1178,2401,1933,0,177,755,2312,1555,0.5700197238658777,0.6820175438596491,0.04363905325443787,0.33114035087719296
DJI_0339.JPG,169.jpg,ong_noi,869,320,908,448,0,39,128,888,384,0.21893491124260356,0.16842105263157894,0.009615384615384616,0.056140350877192984
DJI_0339.JPG,169.jpg,ong_noi,2013,531,2062,681,0,49,150,2037,606,0.5022189349112426,0.2657894736842105,0.012080867850098619,0.06578947368421052
DJI_0340.JPG,170.jpg,ong_noi,2170,1377,2298,2085,0,128,708,2234,1731,0.5507889546351085,0.7592105263157894,0.03155818540433925,0.3105263157894737
DJI_0340.JPG,170.jpg,ong_noi,1143,237,1198,357,0,55,120,1170,297,0.28846153846153844,0.13026315789473683,0.013560157790927022,0.05263157894736842
DJI_0341.JPG,171.jpg,ong_noi,2269,752,2367,1317,0,98,565,2318,1034,0.5714990138067061,0.4535087719298246,0.024161735700197237,0.24780701754385964
DJI_0341.JPG,171.jpg,ong_noi,1261,117,1311,248,0,50,131,1286,182,0.3170611439842209,0.07982456140350877,0.01232741617357002,0.05745614035087719
DJI_0342.JPG,172.jpg,ong_noi,2447,739,2585,1375,0,138,636,2516,1057,0.6203155818540433,0.4635964912280702,0.034023668639053255,0.2789473684210526
DJI_0342.JPG,172.jpg,ong_noi,1587,42,1635,158,0,48,116,1611,100,0.39718934911242604,0.043859649122807015,0.011834319526627219,0.05087719298245614
DJI_0343.JPG,173.jpg,ong_noi,2257,777,2565,1447,0,308,670,2411,1112,0.5944280078895463,0.48771929824561405,0.07593688362919132,0.29385964912280704
DJI_0344.JPG,174.jpg,ong_noi,2299,884,2667,1543,0,368,659,2483,1213,0.6121794871794872,0.5320175438596492,0.09072978303747535,0.28903508771929826
DJI_0345.JPG,175.jpg,ong_noi,2301,991,2688,1651,0,387,660,2494,1321,0.6148915187376726,0.5793859649122807,0.09541420118343195,0.2894736842105263
DJI_0345.JPG,175.jpg,ong_noi,2262,54,2341,169,0,79,115,2301,111,0.5673076923076923,0.04868421052631579,0.01947731755424063,0.05043859649122807
DJI_0346.JPG,176.jpg,ong_noi,2327,1014,2757,1639,0,430,625,2542,1326,0.6267258382642998,0.5815789473684211,0.10601577909270217,0.2741228070175439
DJI_0346.JPG,176.jpg,ong_noi,2389,78,2471,186,0,82,108,2430,132,0.599112426035503,0.05789473684210526,0.02021696252465483,0.04736842105263158
DJI_0347.JPG,177.jpg,ong_noi,2390,1136,2874,1690,0,484,554,2632,1413,0.6489151873767258,0.6197368421052631,0.11932938856015779,0.24298245614035088
DJI_0347.JPG,177.jpg,ong_noi,2635,125,2738,230,0,103,105,2686,177,0.6622287968441815,0.07763157894736843,0.025394477317554242,0.046052631578947366
DJI_0348.JPG,178.jpg,ong_noi,2622,1319,3235,1828,0,613,509,2928,1573,0.7218934911242604,0.6899122807017544,0.15113412228796844,0.22324561403508772
DJI_0348.JPG,178.jpg,ong_noi,3051,231,3196,330,0,145,99,3123,280,0.7699704142011834,0.12280701754385964,0.03574950690335306,0.04342105263157895
DJI_0349.JPG,179.jpg,ong_noi,2021,1166,2678,1663,0,657,497,2349,1414,0.5791420118343196,0.6201754385964913,0.16198224852071005,0.2179824561403509
DJI_0349.JPG,179.jpg,ong_noi,2954,205,3108,314,0,154,109,3031,259,0.7472879684418146,0.11359649122807018,0.03796844181459566,0.04780701754385965
DJI_0349.JPG,179.jpg,ong_noi,3635,1188,3768,1294,0,133,106,3701,1241,0.9124753451676528,0.5442982456140351,0.03279092702169625,0.04649122807017544
DJI_0350.JPG,180.jpg,ong_noi,2147,1202,2789,1654,0,642,452,2468,1428,0.6084812623274162,0.6263157894736842,0.15828402366863906,0.19824561403508772
DJI_0350.JPG,180.jpg,ong_noi,3078,259,3207,337,0,129,78,3142,298,0.77465483234714,0.1307017543859649,0.031804733727810654,0.034210526315789476
DJI_0350.JPG,180.jpg,ong_noi,3720,1265,3849,1364,0,129,99,3784,1314,0.9329388560157791,0.5763157894736842,0.031804733727810654,0.04342105263157895
DJI_0351.JPG,181.jpg,ong_noi,2041,1280,2726,1715,0,685,435,2383,1497,0.5875246548323472,0.656578947368421,0.16888560157790927,0.19078947368421054
DJI_0351.JPG,181.jpg,ong_noi,3140,288,3282,372,0,142,84,3211,330,0.7916666666666666,0.14473684210526316,0.035009861932938854,0.03684210526315789
DJI_0351.JPG,181.jpg,ong_noi,3753,1324,3903,1437,0,150,113,3828,1380,0.9437869822485208,0.6052631578947368,0.03698224852071006,0.04956140350877193
DJI_0352.JPG,182.jpg,ong_noi,2118,1322,2836,1755,0,718,433,2477,1538,0.6107001972386588,0.6745614035087719,0.17702169625246547,0.1899122807017544
DJI_0352.JPG,182.jpg,ong_noi,3231,335,3368,412,0,137,77,3299,373,0.8133629191321499,0.16359649122807018,0.03377712031558185,0.033771929824561404
DJI_0352.JPG,182.jpg,ong_noi,3833,1397,3963,1494,0,130,97,3898,1445,0.9610453648915187,0.6337719298245614,0.03205128205128205,0.04254385964912281
DJI_0353.JPG,183.jpg,ong_noi,1506,1324,2280,1757,0,774,433,1893,1540,0.46671597633136097,0.6754385964912281,0.1908284023668639,0.1899122807017544
DJI_0353.JPG,183.jpg,ong_noi,3179,351,3329,433,0,150,82,3254,392,0.8022682445759369,0.17192982456140352,0.03698224852071006,0.035964912280701755
DJI_0353.JPG,183.jpg,ong_noi,3767,1438,3899,1532,0,132,94,3833,1485,0.9450197238658777,0.6513157894736842,0.03254437869822485,0.0412280701754386
DJI_0354.JPG,184.jpg,ong_noi,1635,1405,2453,1746,0,818,341,2044,1575,0.5039447731755424,0.6907894736842105,0.20167652859960553,0.14956140350877192
DJI_0354.JPG,184.jpg,ong_noi,3462,493,3641,561,0,179,68,3551,527,0.8754930966469427,0.23114035087719298,0.044132149901380674,0.02982456140350877
DJI_0355.JPG,185.jpg,ong_noi,1630,1536,2511,1750,0,881,214,2070,1643,0.5103550295857988,0.7206140350877193,0.21720907297830375,0.09385964912280702
DJI_0355.JPG,185.jpg,ong_noi,3831,773,4018,822,0,187,49,3924,797,0.9674556213017751,0.3495614035087719,0.04610453648915187,0.02149122807017544
DJI_0356.JPG,186.jpg,ong_noi,1711,1598,2539,1785,0,828,187,2125,1691,0.5239151873767258,0.7416666666666667,0.20414201183431951,0.08201754385964913
DJI_0356.JPG,186.jpg,ong_noi,973,1139,1223,1235,0,250,96,1098,1187,0.27071005917159763,0.5206140350877193,0.0616370808678501,0.042105263157894736
DJI_0357.JPG,187.jpg,ong_noi,1749,102,2543,264,0,794,162,2146,183,0.5290927021696252,0.08026315789473684,0.1957593688362919,0.07105263157894737
DJI_0358.JPG,188.jpg,ong_noi,1794,763,2615,908,0,821,145,2204,835,0.5433925049309665,0.36622807017543857,0.20241617357001973,0.06359649122807018
DJI_0358.JPG,188.jpg,ong_noi,974,267,1186,320,0,212,53,1080,293,0.26627218934911245,0.12850877192982457,0.05226824457593689,0.02324561403508772
DJI_0359.JPG,189.jpg,ong_noi,1791,842,2577,927,0,786,85,2184,884,0.5384615384615384,0.387719298245614,0.1937869822485207,0.03728070175438596
DJI_0359.JPG,189.jpg,ong_noi,1084,208,1285,265,0,201,57,1184,236,0.29191321499013806,0.10350877192982456,0.04955621301775148,0.025
DJI_0360.JPG,190.jpg,ong_noi,1852,872,2790,1110,0,938,238,2321,991,0.5722386587771203,0.43464912280701756,0.23126232741617356,0.10438596491228071
DJI_0360.JPG,190.jpg,ong_noi,1389,100,1618,155,0,229,55,1503,127,0.37056213017751477,0.05570175438596491,0.05645956607495069,0.02412280701754386
DJI_0361.JPG,191.jpg,ong_noi,1626,928,2470,1174,0,844,246,2048,1051,0.504930966469428,0.46096491228070174,0.20808678500986194,0.10789473684210527
DJI_0361.JPG,191.jpg,ong_noi,1462,70,1705,139,0,243,69,1583,104,0.39028599605522685,0.0456140350877193,0.059911242603550297,0.030263157894736843
DJI_0364.JPG,192.jpg,khoa_neo,395,1392,515,1483,1,120,91,455,1437,0.11217948717948718,0.6302631578947369,0.029585798816568046,0.039912280701754385
DJI_0364.JPG,192.jpg,khoa_neo,56,89,160,148,1,104,59,108,118,0.026627218934911243,0.05175438596491228,0.02564102564102564,0.02587719298245614
DJI_0364.JPG,192.jpg,khoa_neo,2450,1424,2739,1523,1,289,99,2594,1473,0.6395463510848126,0.6460526315789473,0.07125246548323472,0.04342105263157895
DJI_0364.JPG,192.jpg,khoa_neo,1990,1699,2324,1809,1,334,110,2157,1754,0.5318047337278107,0.769298245614035,0.08234714003944774,0.04824561403508772
DJI_0364.JPG,192.jpg,tru_su,336,3,837,125,2,501,122,586,64,0.14447731755424062,0.028070175438596492,0.1235207100591716,0.05350877192982456
DJI_0364.JPG,192.jpg,tru_su,762,1327,1256,1470,2,494,143,1009,1398,0.248767258382643,0.6131578947368421,0.12179487179487179,0.06271929824561404
DJI_0364.JPG,192.jpg,tru_su,1767,1080,1816,1196,2,49,116,1791,1138,0.4415680473372781,0.49912280701754386,0.012080867850098619,0.05087719298245614
DJI_0364.JPG,192.jpg,tru_su,1941,923,2098,1092,2,157,169,2019,1007,0.4977810650887574,0.44166666666666665,0.038708086785009865,0.07412280701754385
DJI_0365.JPG,193.jpg,khoa_neo,381,1372,506,1462,1,125,90,443,1417,0.10922090729783038,0.6214912280701754,0.03081854043392505,0.039473684210526314
DJI_0365.JPG,193.jpg,khoa_neo,42,60,156,117,1,114,57,99,88,0.02440828402366864,0.03859649122807018,0.028106508875739646,0.025
DJI_0365.JPG,193.jpg,khoa_neo,2494,1355,2791,1455,1,297,100,2642,1405,0.6513806706114399,0.6162280701754386,0.07322485207100592,0.043859649122807015
DJI_0365.JPG,193.jpg,khoa_neo,2026,1628,2367,1742,1,341,114,2196,1685,0.5414201183431953,0.7390350877192983,0.08407297830374753,0.05
DJI_0365.JPG,193.jpg,tru_su,332,1,837,93,2,505,92,584,47,0.14398422090729784,0.0206140350877193,0.1245069033530572,0.04035087719298246
DJI_0365.JPG,193.jpg,tru_su,765,1306,1248,1446,2,483,140,1006,1376,0.2480276134122288,0.6035087719298246,0.11908284023668639,0.06140350877192982
DJI_0365.JPG,193.jpg,tru_su,1773,1051,1817,1170,2,44,119,1795,1110,0.4425542406311637,0.4868421052631579,0.010848126232741617,0.052192982456140354
DJI_0365.JPG,193.jpg,tru_su,1976,913,2108,1074,2,132,161,2042,993,0.5034516765285996,0.4355263157894737,0.03254437869822485,0.0706140350877193
DJI_0365.JPG,193.jpg,tru_su,3489,1194,4056,1696,2,567,502,3772,1445,0.9299802761341223,0.6337719298245614,0.13979289940828402,0.22017543859649122
DJI_0366.JPG,194.jpg,khoa_neo,269,1372,415,1485,1,146,113,342,1428,0.08431952662721894,0.6263157894736842,0.03599605522682446,0.04956140350877193
DJI_0366.JPG,194.jpg,khoa_neo,2099,1355,2407,1458,1,308,103,2253,1406,0.5554733727810651,0.6166666666666667,0.07593688362919132,0.04517543859649123
DJI_0366.JPG,194.jpg,khoa_neo,1569,1634,1912,1753,1,343,119,1740,1693,0.4289940828402367,0.7425438596491228,0.08456607495069034,0.052192982456140354
DJI_0366.JPG,194.jpg,khoa_neo,2,55,53,120,1,51,65,27,87,0.006656804733727811,0.038157894736842106,0.01257396449704142,0.02850877192982456
DJI_0366.JPG,194.jpg,tru_su,215,1,714,90,2,499,89,464,45,0.11439842209072978,0.019736842105263157,0.1230276134122288,0.03903508771929825
DJI_0366.JPG,194.jpg,tru_su,643,1308,1156,1449,2,513,141,899,1378,0.22164694280078895,0.6043859649122807,0.1264792899408284,0.06184210526315789
DJI_0366.JPG,194.jpg,tru_su,3110,1161,4056,1704,2,946,543,3583,1432,0.8833826429980276,0.6280701754385964,0.23323471400394477,0.2381578947368421
DJI_0366.JPG,194.jpg,tru_su,3397,1630,3701,2007,2,304,377,3549,1818,0.875,0.7973684210526316,0.07495069033530571,0.16535087719298244
DJI_0366.JPG,194.jpg,tru_su,1891,911,2050,1072,2,159,161,1970,991,0.48570019723865876,0.43464912280701756,0.03920118343195266,0.0706140350877193
DJI_0366.JPG,194.jpg,tru_su,1682,1048,1731,1253,2,49,205,1706,1150,0.42061143984220906,0.5043859649122807,0.012080867850098619,0.08991228070175439
DJI_0367.JPG,195.jpg,khoa_neo,177,1312,326,1415,1,149,103,251,1363,0.061883629191321496,0.5978070175438597,0.03673570019723866,0.04517543859649123
DJI_0367.JPG,195.jpg,khoa_neo,2307,1036,2737,1185,1,430,149,2522,1110,0.6217948717948718,0.4868421052631579,0.10601577909270217,0.06535087719298245
DJI_0367.JPG,195.jpg,khoa_neo,1569,1385,2083,1566,1,514,181,1826,1475,0.45019723865877714,0.6469298245614035,0.1267258382642998,0.0793859649122807
DJI_0367.JPG,195.jpg,tru_su,577,1244,1102,1396,2,525,152,839,1320,0.20685404339250493,0.5789473684210527,0.1294378698224852,0.06666666666666667
DJI_0367.JPG,195.jpg,tru_su,3692,845,4056,1490,2,364,645,3874,1167,0.9551282051282052,0.5118421052631579,0.08974358974358974,0.28289473684210525
DJI_0367.JPG,195.jpg,tru_su,3567,1576,3928,2007,2,361,431,3747,1791,0.9238165680473372,0.7855263157894737,0.08900394477317554,0.18903508771929825
DJI_0367.JPG,195.jpg,tru_su,1686,974,1739,1262,2,53,288,1712,1118,0.42209072978303747,0.4903508771929825,0.013067061143984222,0.12631578947368421
DJI_0367.JPG,195.jpg,tru_su,1901,821,2058,1008,2,157,187,1979,914,0.4879191321499014,0.40087719298245617,0.038708086785009865,0.08201754385964913
DJI_0368.JPG,196.jpg,khoa_neo,147,1274,291,1388,1,144,114,219,1331,0.053994082840236685,0.5837719298245614,0.03550295857988166,0.05
DJI_0368.JPG,196.jpg,khoa_neo,2093,893,2534,1055,1,441,162,2313,974,0.5702662721893491,0.42719298245614035,0.10872781065088757,0.07105263157894737
DJI_0368.JPG,196.jpg,khoa_neo,1269,1231,1826,1426,1,557,195,1547,1328,0.3814102564102564,0.5824561403508772,0.13732741617357003,0.08552631578947369
DJI_0368.JPG,196.jpg,tru_su,540,1211,1108,1356,2,568,145,824,1283,0.20315581854043394,0.5627192982456141,0.14003944773175542,0.06359649122807018
DJI_0368.JPG,196.jpg,tru_su,3559,687,4056,1355,2,497,668,3807,1021,0.9386094674556213,0.44780701754385965,0.122534516765286,0.2929824561403509
DJI_0368.JPG,196.jpg,tru_su,3541,1562,3835,1959,2,294,397,3688,1760,0.9092702169625246,0.7719298245614035,0.07248520710059171,0.17412280701754385
DJI_0369.JPG,197.jpg,khoa_neo,1723,753,2215,942,1,492,189,1969,847,0.4854536489151874,0.3714912280701754,0.12130177514792899,0.08289473684210526
DJI_0369.JPG,197.jpg,khoa_neo,766,1026,1339,1242,1,573,216,1052,1134,0.2593688362919132,0.49736842105263157,0.14127218934911243,0.09473684210526316
DJI_0369.JPG,197.jpg,khoa_neo,404,1158,547,1258,1,143,100,475,1208,0.11711045364891519,0.5298245614035088,0.035256410256410256,0.043859649122807015
DJI_0369.JPG,197.jpg,tru_su,775,1137,1289,1248,2,514,111,1032,1192,0.25443786982248523,0.5228070175438596,0.1267258382642998,0.04868421052631579
DJI_0369.JPG,197.jpg,tru_su,3331,586,4056,1284,2,725,698,3693,935,0.9105029585798816,0.4100877192982456,0.17874753451676528,0.306140350877193
DJI_0369.JPG,197.jpg,tru_su,3762,1647,4056,2070,2,294,423,3909,1858,0.9637573964497042,0.8149122807017544,0.07248520710059171,0.18552631578947368
DJI_0370.JPG,198.jpg,khoa_neo,310,1161,466,1263,1,156,102,388,1212,0.09566074950690336,0.531578947368421,0.038461538461538464,0.04473684210526316
DJI_0370.JPG,198.jpg,khoa_neo,1210,744,1739,934,1,529,190,1474,839,0.3634122287968442,0.36798245614035086,0.1304240631163708,0.08333333333333333
DJI_0370.JPG,198.jpg,khoa_neo,110,1031,707,1258,1,597,227,408,1144,0.10059171597633136,0.5017543859649123,0.14718934911242604,0.09956140350877193
DJI_0370.JPG,198.jpg,tru_su,705,1144,1202,1260,2,497,116,953,1202,0.23496055226824458,0.5271929824561403,0.122534516765286,0.05087719298245614
DJI_0370.JPG,198.jpg,tru_su,2780,567,4056,1297,2,1276,730,3418,932,0.8427021696252466,0.4087719298245614,0.3145956607495069,0.3201754385964912
DJI_0370.JPG,198.jpg,tru_su,3656,1654,3994,2109,2,338,455,3825,1881,0.9430473372781065,0.825,0.08333333333333333,0.19956140350877194
DJI_0371.JPG,199.jpg,khoa_neo,520,861,1074,1039,1,554,178,797,950,0.19649901380670612,0.4166666666666667,0.13658777120315582,0.0780701754385965
DJI_0371.JPG,199.jpg,tru_su,1923,655,4056,1439,2,2133,784,2989,1047,0.7369329388560157,0.45921052631578946,0.525887573964497,0.34385964912280703
DJI_0371.JPG,199.jpg,tru_su,3500,1676,3819,2148,2,319,472,3659,1912,0.902120315581854,0.8385964912280702,0.07864891518737673,0.20701754385964913
DJI_0372.JPG,200.jpg,tru_su,612,680,4056,1512,2,3444,832,2334,1096,0.5754437869822485,0.4807017543859649,0.849112426035503,0.3649122807017544
DJI_0372.JPG,200.jpg,tru_su,3274,1682,3569,2161,2,295,479,3421,1921,0.8434418145956607,0.8425438596491228,0.07273175542406311,0.2100877192982456
DJI_0373.JPG,201.jpg,tru_su,34,412,2399,1277,2,2365,865,1216,844,0.29980276134122286,0.3701754385964912,0.5830867850098619,0.3793859649122807
DJI_0373.JPG,201.jpg,tru_su,2891,1647,3164,2126,2,273,479,3027,1886,0.746301775147929,0.8271929824561404,0.0673076923076923,0.2100877192982456
DJI_0374.JPG,202.jpg,tru_su,20,836,2399,1704,2,2379,868,1209,1270,0.2980769230769231,0.5570175438596491,0.5865384615384616,0.38070175438596493
DJI_0374.JPG,202.jpg,tru_su,2876,1715,3148,2214,2,272,499,3012,1964,0.742603550295858,0.8614035087719298,0.0670611439842209,0.218859649122807
DJI_0375.JPG,203.jpg,khoa_neo,1142,1207,1407,1399,1,265,192,1274,1303,0.3141025641025641,0.5714912280701754,0.0653353057199211,0.08421052631578947
DJI_0375.JPG,203.jpg,khoa_neo,599,1212,831,1415,1,232,203,715,1313,0.1762820512820513,0.5758771929824561,0.05719921104536489,0.08903508771929824
DJI_0375.JPG,203.jpg,khoa_neo,1893,1034,1966,1093,1,73,59,1929,1063,0.4755917159763314,0.4662280701754386,0.01799802761341223,0.02587719298245614
DJI_0375.JPG,203.jpg,tru_su,1318,1465,3195,2280,2,1877,815,2256,1872,0.5562130177514792,0.8210526315789474,0.46277120315581854,0.3574561403508772
DJI_0375.JPG,203.jpg,tru_su,2069,1122,2471,1300,2,402,178,2270,1211,0.5596646942800789,0.531140350877193,0.09911242603550297,0.0780701754385965
DJI_0376.JPG,204.jpg,khoa_neo,1888,940,2055,1148,1,167,208,1971,1044,0.4859467455621302,0.45789473684210524,0.04117357001972387,0.0912280701754386
DJI_0376.JPG,204.jpg,khoa_neo,2330,1066,2498,1288,1,168,222,2414,1177,0.5951676528599605,0.5162280701754386,0.04142011834319527,0.09736842105263158
DJI_0376.JPG,204.jpg,tru_su,2413,1636,3449,2280,2,1036,644,2931,1958,0.7226331360946746,0.8587719298245614,0.25542406311637084,0.2824561403508772
DJI_0376.JPG,204.jpg,tru_su,3162,510,3592,795,2,430,285,3377,652,0.8325936883629191,0.28596491228070176,0.10601577909270217,0.125
DJI_0376.JPG,204.jpg,khoa_neo,1755,1041,1843,1277,1,88,236,1799,1159,0.4435404339250493,0.5083333333333333,0.021696252465483234,0.10350877192982456
DJI_0376.JPG,204.jpg,khoa_neo,1869,1004,2017,1300,1,148,296,1943,1152,0.47904339250493094,0.5052631578947369,0.03648915187376726,0.12982456140350876
DJI_0377.JPG,205.jpg,khoa_neo,1912,1007,2118,1331,1,206,324,2015,1169,0.4967948717948718,0.512719298245614,0.050788954635108484,0.14210526315789473
DJI_0377.JPG,205.jpg,khoa_neo,1785,1042,1910,1304,1,125,262,1847,1173,0.45537475345167655,0.5144736842105263,0.03081854043392505,0.11491228070175438
DJI_0377.JPG,205.jpg,khoa_neo,3080,315,3239,434,1,159,119,3159,374,0.7788461538461539,0.16403508771929826,0.03920118343195266,0.052192982456140354
DJI_0377.JPG,205.jpg,tru_su,3296,488,3778,796,2,482,308,3537,642,0.8720414201183432,0.28157894736842104,0.11883629191321499,0.13508771929824562
DJI_0377.JPG,205.jpg,tru_su,2698,1905,3578,2274,2,880,369,3138,2089,0.7736686390532544,0.9162280701754386,0.21696252465483234,0.1618421052631579
DJI_0378.JPG,206.jpg,khoa_neo,2210,985,2320,1312,1,110,327,2265,1148,0.5584319526627219,0.5035087719298246,0.027120315581854043,0.14342105263157895
DJI_0378.JPG,206.jpg,khoa_neo,2080,990,2139,1182,1,59,192,2109,1086,0.5199704142011834,0.4763157894736842,0.014546351084812623,0.08421052631578947
DJI_0378.JPG,206.jpg,khoa_neo,3561,447,3685,547,1,124,100,3623,497,0.8932445759368837,0.2179824561403509,0.03057199211045365,0.043859649122807015
DJI_0378.JPG,206.jpg,tru_su,3781,655,4056,940,2,275,285,3918,797,0.9659763313609467,0.3495614035087719,0.06780078895463511,0.125
DJI_0378.JPG,206.jpg,tru_su,2292,1989,3205,2280,2,913,291,2748,2134,0.6775147928994083,0.9359649122807018,0.22509861932938857,0.12763157894736843
DJI_0379.JPG,207.jpg,khoa_neo,2430,925,2661,1291,1,231,366,2545,1108,0.627465483234714,0.48596491228070177,0.05695266272189349,0.16052631578947368
DJI_0379.JPG,207.jpg,khoa_neo,2320,1080,2493,1507,1,173,427,2406,1293,0.5931952662721893,0.5671052631578948,0.04265285996055227,0.18728070175438596
DJI_0379.JPG,207.jpg,khoa_neo,2888,1488,3177,2053,1,289,565,3032,1770,0.747534516765286,0.7763157894736842,0.07125246548323472,0.24780701754385964
DJI_0380.JPG,208.jpg,khoa_neo,3063,1223,3202,1513,1,139,290,3132,1368,0.772189349112426,0.6,0.034270216962524656,0.12719298245614036
DJI_0380.JPG,208.jpg,khoa_neo,3235,1273,3342,1667,1,107,394,3288,1470,0.8106508875739645,0.6447368421052632,0.02638067061143984,0.17280701754385966
DJI_0380.JPG,208.jpg,khoa_neo,2709,1501,2813,1975,1,104,474,2761,1738,0.6807199211045365,0.762280701754386,0.02564102564102564,0.20789473684210527
DJI_0381.JPG,209.jpg,khoa_neo,2934,449,3091,753,1,157,304,3012,601,0.742603550295858,0.26359649122807016,0.038708086785009865,0.13333333333333333
DJI_0381.JPG,209.jpg,khoa_neo,3086,516,3240,896,1,154,380,3163,706,0.7798323471400395,0.30964912280701756,0.03796844181459566,0.16666666666666666
DJI_0381.JPG,209.jpg,khoa_neo,2307,822,2422,1138,1,115,316,2364,980,0.5828402366863905,0.4298245614035088,0.028353057199211044,0.13859649122807016
DJI_0381.JPG,209.jpg,khoa_neo,2636,1410,2734,1821,1,98,411,2685,1615,0.6619822485207101,0.7083333333333334,0.024161735700197237,0.18026315789473685
DJI_0381.JPG,209.jpg,tru_su,2678,2029,3006,2280,2,328,251,2842,2154,0.7006903353057199,0.9447368421052632,0.08086785009861933,0.11008771929824561
DJI_0382.JPG,210.jpg,khoa_neo,2880,496,3053,785,1,173,289,2966,640,0.7312623274161736,0.2807017543859649,0.04265285996055227,0.1267543859649123
DJI_0382.JPG,210.jpg,khoa_neo,3024,555,3199,938,1,175,383,3111,746,0.7670118343195266,0.32719298245614037,0.04314595660749507,0.16798245614035087
DJI_0382.JPG,210.jpg,khoa_neo,1946,812,2077,1152,1,131,340,2011,982,0.4958086785009862,0.4307017543859649,0.03229783037475345,0.14912280701754385
DJI_0382.JPG,210.jpg,tru_su,2536,2063,2855,2280,2,319,217,2695,2171,0.664447731755424,0.9521929824561404,0.07864891518737673,0.09517543859649123
DJI_0382.JPG,210.jpg,khoa_neo,2153,1417,2291,1836,1,138,419,2222,1626,0.5478303747534516,0.7131578947368421,0.034023668639053255,0.1837719298245614
DJI_0383.JPG,211.jpg,khoa_neo,3017,612,3215,904,1,198,292,3116,758,0.7682445759368837,0.33245614035087717,0.04881656804733728,0.1280701754385965
DJI_0383.JPG,211.jpg,khoa_neo,3150,688,3365,1062,1,215,374,3257,875,0.803007889546351,0.38377192982456143,0.053007889546351085,0.16403508771929826
DJI_0383.JPG,211.jpg,khoa_neo,1967,898,2135,1224,1,168,326,2051,1061,0.5056706114398422,0.46535087719298246,0.04142011834319527,0.14298245614035088
DJI_0383.JPG,211.jpg,khoa_neo,2155,1518,2301,1920,1,146,402,2228,1719,0.5493096646942801,0.7539473684210526,0.03599605522682446,0.1763157894736842
DJI_0383.JPG,211.jpg,tru_su,2537,2145,2811,2280,2,274,135,2674,2212,0.6592702169625246,0.9701754385964912,0.0675542406311637,0.05921052631578947
DJI_0384.JPG,212.jpg,khoa_neo,2037,958,2226,1282,1,189,324,2131,1120,0.5253944773175543,0.49122807017543857,0.04659763313609468,0.14210526315789473
DJI_0384.JPG,212.jpg,khoa_neo,2156,1599,2323,1999,1,167,400,2239,1799,0.5520216962524654,0.7890350877192982,0.04117357001972387,0.17543859649122806
DJI_0384.JPG,212.jpg,khoa_neo,3151,720,3369,1021,1,218,301,3260,870,0.8037475345167653,0.3815789473684211,0.05374753451676528,0.13201754385964912
DJI_0384.JPG,212.jpg,khoa_neo,3259,818,3527,1180,1,268,362,3393,999,0.8365384615384616,0.4381578947368421,0.06607495069033531,0.1587719298245614
DJI_0385.JPG,213.jpg,khoa_neo,2115,680,2291,985,1,176,305,2203,832,0.5431459566074951,0.3649122807017544,0.04339250493096647,0.1337719298245614
DJI_0385.JPG,213.jpg,khoa_neo,2223,1247,2393,1612,1,170,365,2308,1429,0.5690335305719921,0.6267543859649123,0.041913214990138066,0.1600877192982456
DJI_0385.JPG,213.jpg,khoa_neo,3152,630,3378,911,1,226,281,3265,770,0.8049802761341223,0.33771929824561403,0.05571992110453649,0.12324561403508771
DJI_0385.JPG,213.jpg,khoa_neo,3271,716,3518,1087,1,247,371,3394,901,0.8367850098619329,0.39517543859649124,0.060897435897435896,0.16271929824561404
DJI_0385.JPG,213.jpg,tru_su,2538,2071,2867,2280,2,329,209,2702,2175,0.6661735700197239,0.9539473684210527,0.08111439842209073,0.09166666666666666
DJI_0386.JPG,214.jpg,khoa_neo,2193,699,2426,1004,1,233,305,2309,851,0.5692800788954635,0.3732456140350877,0.057445759368836294,0.1337719298245614
DJI_0386.JPG,214.jpg,khoa_neo,2199,1299,2458,1647,1,259,348,2328,1473,0.5739644970414202,0.6460526315789473,0.06385601577909271,0.15263157894736842
DJI_0386.JPG,214.jpg,khoa_neo,3343,781,3603,1047,1,260,266,3473,914,0.8562623274161736,0.40087719298245617,0.0641025641025641,0.11666666666666667
DJI_0386.JPG,214.jpg,khoa_neo,3442,882,3743,1237,1,301,355,3592,1059,0.8856015779092702,0.4644736842105263,0.07421104536489152,0.15570175438596492
DJI_0386.JPG,214.jpg,tru_su,2553,2170,2709,2280,2,156,110,2631,2225,0.6486686390532544,0.9758771929824561,0.038461538461538464,0.04824561403508772
DJI_0387.JPG,215.jpg,khoa_neo,2148,654,2386,961,1,238,307,2267,807,0.5589250493096647,0.3539473684210526,0.058678500986193295,0.13464912280701755
DJI_0387.JPG,215.jpg,khoa_neo,2143,1294,2391,1677,1,248,383,2267,1485,0.5589250493096647,0.6513157894736842,0.0611439842209073,0.16798245614035087
DJI_0387.JPG,215.jpg,khoa_neo,3387,816,3661,1084,1,274,268,3524,950,0.868836291913215,0.4166666666666667,0.0675542406311637,0.11754385964912281
DJI_0387.JPG,215.jpg,khoa_neo,3483,926,3798,1287,1,315,361,3640,1106,0.8974358974358975,0.4850877192982456,0.07766272189349112,0.15833333333333333
DJI_0387.JPG,215.jpg,tru_su,2573,2207,2693,2280,2,120,73,2633,2243,0.6491617357001972,0.9837719298245614,0.029585798816568046,0.032017543859649125
DJI_0388.JPG,216.jpg,khoa_neo,2007,770,2247,1075,1,240,305,2127,922,0.5244082840236687,0.4043859649122807,0.05917159763313609,0.1337719298245614
DJI_0388.JPG,216.jpg,khoa_neo,1936,1410,2215,1790,1,279,380,2075,1600,0.5115877712031558,0.7017543859649122,0.06878698224852071,0.16666666666666666
DJI_0388.JPG,216.jpg,khoa_neo,3370,892,3646,1149,1,276,257,3508,1020,0.8648915187376726,0.4473684210526316,0.06804733727810651,0.11271929824561404
DJI_0388.JPG,216.jpg,khoa_neo,3459,1003,3781,1350,1,322,347,3620,1176,0.8925049309664694,0.5157894736842106,0.07938856015779093,0.15219298245614035
DJI_0389.JPG,217.jpg,khoa_neo,2010,786,2276,1079,1,266,293,2143,932,0.528353057199211,0.4087719298245614,0.0655818540433925,0.12850877192982457
DJI_0389.JPG,217.jpg,khoa_neo,1870,1443,2171,1805,1,301,362,2020,1624,0.4980276134122288,0.712280701754386,0.07421104536489152,0.1587719298245614
DJI_0389.JPG,217.jpg,khoa_neo,3464,1026,3780,1277,1,316,251,3622,1151,0.8929980276134122,0.5048245614035087,0.07790927021696252,0.11008771929824561
DJI_0389.JPG,217.jpg,khoa_neo,3552,1155,3914,1477,1,362,322,3733,1316,0.9203648915187377,0.5771929824561404,0.08925049309664694,0.1412280701754386
DJI_0389.JPG,217.jpg,tru_su,220,1850,896,2280,2,676,430,558,2065,0.13757396449704143,0.9057017543859649,0.16666666666666666,0.18859649122807018
DJI_0390.JPG,218.jpg,khoa_neo,1994,804,2287,1091,1,293,287,2140,947,0.5276134122287969,0.41535087719298247,0.07223865877712031,0.12587719298245614
DJI_0390.JPG,218.jpg,khoa_neo,1788,1485,2123,1846,1,335,361,1955,1665,0.48200197238658776,0.7302631578947368,0.08259368836291914,0.15833333333333333
DJI_0390.JPG,218.jpg,khoa_neo,3566,1151,3899,1391,1,333,240,3732,1271,0.9201183431952663,0.5574561403508772,0.08210059171597633,0.10526315789473684
DJI_0390.JPG,218.jpg,khoa_neo,3626,1296,4026,1621,1,400,325,3826,1458,0.9432938856015779,0.6394736842105263,0.09861932938856016,0.1425438596491228
DJI_0390.JPG,218.jpg,tru_su,12,1793,761,2280,2,749,487,386,2036,0.09516765285996055,0.8929824561403509,0.1846646942800789,0.21359649122807017
DJI_0391.JPG,219.jpg,khoa_neo,2126,863,2472,1117,1,346,254,2299,990,0.5668145956607495,0.4342105263157895,0.08530571992110454,0.11140350877192982
DJI_0391.JPG,219.jpg,khoa_neo,1777,1509,2150,1812,1,373,303,1963,1660,0.483974358974359,0.7280701754385965,0.09196252465483234,0.13289473684210526
DJI_0391.JPG,219.jpg,khoa_neo,3781,1624,4056,1742,1,275,118,3918,1683,0.9659763313609467,0.7381578947368421,0.06780078895463511,0.05175438596491228
DJI_0391.JPG,219.jpg,khoa_neo,3804,1850,4056,1976,1,252,126,3930,1913,0.9689349112426036,0.8390350877192982,0.0621301775147929,0.05526315789473684
DJI_0391.JPG,219.jpg,tru_su,10,1515,785,2280,2,775,765,397,1897,0.09787968441814596,0.8320175438596491,0.1910749506903353,0.3355263157894737
DJI_0392.JPG,220.jpg,khoa_neo,2588,1279,3010,1380,1,422,101,2799,1329,0.6900887573964497,0.5828947368421052,0.10404339250493097,0.04429824561403509
DJI_0392.JPG,220.jpg,khoa_neo,1904,1630,2335,1780,1,431,150,2119,1705,0.5224358974358975,0.7478070175438597,0.10626232741617357,0.06578947368421052
DJI_0392.JPG,220.jpg,tru_su,7,790,1229,1677,2,1222,887,618,1233,0.15236686390532544,0.5407894736842105,0.30128205128205127,0.38903508771929823
DJI_0393.JPG,221.jpg,khoa_neo,2802,1590,3238,1775,1,436,185,3020,1682,0.7445759368836292,0.737719298245614,0.10749506903353057,0.08114035087719298
DJI_0393.JPG,221.jpg,khoa_neo,2028,1752,2451,1946,1,423,194,2239,1849,0.5520216962524654,0.8109649122807018,0.10428994082840237,0.08508771929824561
DJI_0393.JPG,221.jpg,tru_su,7,223,1599,1474,2,1592,1251,803,848,0.19797830374753453,0.3719298245614035,0.39250493096646943,0.5486842105263158
DJI_0394.JPG,222.jpg,khoa_neo,2875,1826,3291,2015,1,416,189,3083,1920,0.7601084812623274,0.8421052631578947,0.10256410256410256,0.08289473684210526
DJI_0394.JPG,222.jpg,khoa_neo,2128,1980,2538,2198,1,410,218,2333,2089,0.5751972386587771,0.9162280701754386,0.10108481262327416,0.0956140350877193
DJI_0394.JPG,222.jpg,tru_su,12,412,1696,1731,2,1684,1319,854,1071,0.21055226824457593,0.4697368421052632,0.4151873767258383,0.5785087719298245
DJI_0395.JPG,223.jpg,tru_su,809,616,1049,1212,2,240,596,929,914,0.22904339250493097,0.40087719298245617,0.05917159763313609,0.2614035087719298
DJI_0395.JPG,223.jpg,tru_su,957,631,1183,1250,2,226,619,1070,940,0.26380670611439844,0.41228070175438597,0.05571992110453649,0.27149122807017545
DJI_0395.JPG,223.jpg,tru_su,1397,257,1487,618,2,90,361,1442,437,0.35552268244575935,0.19166666666666668,0.022189349112426034,0.15833333333333333
DJI_0395.JPG,223.jpg,tru_su,1086,1,1157,76,2,71,75,1121,38,0.27638067061143984,0.016666666666666666,0.017504930966469427,0.03289473684210526
DJI_0396.JPG,224.jpg,khoa_neo,2464,780,2651,855,1,187,75,2557,817,0.6304240631163708,0.35833333333333334,0.04610453648915187,0.03289473684210526
DJI_0396.JPG,224.jpg,khoa_neo,2241,1054,2445,1133,1,204,79,2343,1093,0.5776627218934911,0.4793859649122807,0.05029585798816568,0.03464912280701754
DJI_0396.JPG,224.jpg,khoa_neo,2732,569,2770,633,1,38,64,2751,601,0.6782544378698225,0.26359649122807016,0.009368836291913214,0.028070175438596492
DJI_0396.JPG,224.jpg,khoa_neo,2844,605,2892,667,1,48,62,2868,636,0.7071005917159763,0.2789473684210526,0.011834319526627219,0.027192982456140352
DJI_0396.JPG,224.jpg,tru_su,255,804,757,1027,2,502,223,506,915,0.1247534516765286,0.40131578947368424,0.12376725838264299,0.09780701754385965
DJI_0396.JPG,224.jpg,tru_su,1949,1705,2577,2102,2,628,397,2263,1903,0.5579388560157791,0.8346491228070175,0.15483234714003946,0.17412280701754385
DJI_0396.JPG,224.jpg,tru_su,3151,1244,3404,1555,2,253,311,3277,1399,0.8079388560157791,0.6135964912280701,0.0623767258382643,0.13640350877192983
DJI_0396.JPG,224.jpg,tru_su,2858,1868,3144,2105,2,286,237,3001,1986,0.7398915187376726,0.8710526315789474,0.07051282051282051,0.10394736842105264
DJI_0396.JPG,224.jpg,tru_su,1158,428,1245,694,2,87,266,1201,561,0.29610453648915186,0.24605263157894736,0.021449704142011833,0.11666666666666667
DJI_0396.JPG,224.jpg,tru_su,1331,237,1475,428,2,144,191,1403,332,0.34590729783037477,0.1456140350877193,0.03550295857988166,0.0837719298245614
DJI_0397.JPG,225.jpg,khoa_neo,2282,855,2468,926,1,186,71,2375,890,0.585552268244576,0.39035087719298245,0.04585798816568047,0.031140350877192982
DJI_0397.JPG,225.jpg,khoa_neo,2046,1139,2257,1201,1,211,62,2151,1170,0.5303254437869822,0.5131578947368421,0.052021696252465485,0.027192982456140352
DJI_0397.JPG,225.jpg,khoa_neo,2671,589,2722,660,1,51,71,2696,624,0.6646942800788954,0.2736842105263158,0.01257396449704142,0.031140350877192982
DJI_0397.JPG,225.jpg,tru_su,187,825,691,1049,2,504,224,439,937,0.10823471400394477,0.41096491228070176,0.1242603550295858,0.09824561403508772
DJI_0397.JPG,225.jpg,tru_su,1842,1733,2479,2141,2,637,408,2160,1937,0.5325443786982249,0.849561403508772,0.15705128205128205,0.17894736842105263
DJI_0397.JPG,225.jpg,tru_su,2776,1882,3048,2127,2,272,245,2912,2004,0.717948717948718,0.8789473684210526,0.0670611439842209,0.1074561403508772
DJI_0397.JPG,225.jpg,tru_su,3076,1273,3321,1574,2,245,301,3198,1423,0.7884615384615384,0.6241228070175439,0.0604043392504931,0.13201754385964912
DJI_0397.JPG,225.jpg,tru_su,2894,414,3930,995,2,1036,581,3412,704,0.8412228796844181,0.3087719298245614,0.25542406311637084,0.2548245614035088
DJI_0397.JPG,225.jpg,tru_su,1289,254,1424,434,2,135,180,1356,344,0.3343195266272189,0.15087719298245614,0.03328402366863906,0.07894736842105263
DJI_0397.JPG,225.jpg,tru_su,1108,452,1182,701,2,74,249,1145,576,0.2822978303747535,0.25263157894736843,0.01824457593688363,0.10921052631578948
DJI_0398.JPG,226.jpg,khoa_neo,2112,988,2294,1060,1,182,72,2203,1024,0.5431459566074951,0.44912280701754387,0.04487179487179487,0.031578947368421054
DJI_0398.JPG,226.jpg,khoa_neo,1872,1274,2080,1337,1,208,63,1976,1305,0.48717948717948717,0.5723684210526315,0.05128205128205128,0.02763157894736842
DJI_0398.JPG,226.jpg,khoa_neo,2615,635,2647,700,1,32,65,2631,667,0.6486686390532544,0.29254385964912283,0.007889546351084813,0.02850877192982456
DJI_0398.JPG,226.jpg,tru_su,150,878,659,1103,2,509,225,404,990,0.09960552268244575,0.4342105263157895,0.1254930966469428,0.09868421052631579
DJI_0398.JPG,226.jpg,tru_su,1065,503,1148,748,2,83,245,1106,625,0.27268244575936884,0.2741228070175439,0.020463510848126233,0.1074561403508772
DJI_0398.JPG,226.jpg,tru_su,1246,294,1385,494,2,139,200,1315,394,0.32421104536489154,0.17280701754385966,0.034270216962524656,0.08771929824561403
DJI_0398.JPG,226.jpg,tru_su,1752,1790,2411,2178,2,659,388,2081,1984,0.5130670611439843,0.8701754385964913,0.16247534516765286,0.17017543859649123
DJI_0398.JPG,226.jpg,tru_su,2997,1335,3235,1618,2,238,283,3116,1476,0.7682445759368837,0.6473684210526316,0.058678500986193295,0.12412280701754386
DJI_0398.JPG,226.jpg,tru_su,2700,1941,2949,2165,2,249,224,2824,2053,0.6962524654832347,0.900438596491228,0.0613905325443787,0.09824561403508772
DJI_0398.JPG,226.jpg,tru_su,2710,547,3856,1127,2,1146,580,3283,837,0.8094181459566075,0.3671052631578947,0.28254437869822485,0.2543859649122807
DJI_0399.JPG,227.jpg,khoa_neo,1892,1070,2080,1138,1,188,68,1986,1104,0.4896449704142012,0.4842105263157895,0.046351084812623275,0.02982456140350877
DJI_0399.JPG,227.jpg,khoa_neo,1631,1337,1853,1420,1,222,83,1742,1378,0.42948717948717946,0.6043859649122807,0.05473372781065089,0.03640350877192983
DJI_0399.JPG,227.jpg,tru_su,80,908,581,1135,2,501,227,330,1021,0.08136094674556213,0.44780701754385965,0.1235207100591716,0.09956140350877193
DJI_0399.JPG,227.jpg,tru_su,1180,324,1329,510,2,149,186,1254,417,0.3091715976331361,0.18289473684210528,0.03673570019723866,0.08157894736842106
DJI_0399.JPG,227.jpg,tru_su,1644,1820,2273,2224,2,629,404,1958,2022,0.482741617357002,0.8868421052631579,0.15507889546351084,0.17719298245614035
DJI_0399.JPG,227.jpg,tru_su,2590,1975,2830,2195,2,240,220,2710,2085,0.6681459566074951,0.9144736842105263,0.05917159763313609,0.09649122807017543
DJI_0399.JPG,227.jpg,tru_su,2912,1363,3137,1644,2,225,281,3024,1503,0.7455621301775148,0.6592105263157895,0.05547337278106509,0.12324561403508771
DJI_0399.JPG,227.jpg,tru_su,2496,622,3643,1203,2,1147,581,3069,912,0.7566568047337278,0.4,0.2827909270216962,0.2548245614035088
DJI_0400.JPG,228.jpg,tru_su,2848,1369,3116,1681,2,268,312,2982,1525,0.735207100591716,0.668859649122807,0.06607495069033531,0.1368421052631579
DJI_0400.JPG,228.jpg,tru_su,30,921,542,1160,2,512,239,286,1040,0.07051282051282051,0.45614035087719296,0.126232741617357,0.10482456140350878
DJI_0400.JPG,228.jpg,tru_su,1618,1836,2254,2240,2,636,404,1936,2038,0.47731755424063116,0.893859649122807,0.15680473372781065,0.17719298245614035
DJI_0400.JPG,228.jpg,tru_su,2507,1997,2772,2236,2,265,239,2639,2116,0.6506410256410257,0.9280701754385965,0.0653353057199211,0.10482456140350878
DJI_0400.JPG,228.jpg,tru_su,2538,648,3519,1219,2,981,571,3028,933,0.7465483234714004,0.40921052631578947,0.24186390532544377,0.25043859649122807
DJI_0400.JPG,228.jpg,tru_su,1148,328,1293,481,2,145,153,1220,404,0.30078895463510846,0.17719298245614035,0.03574950690335306,0.06710526315789474
DJI_0400.JPG,228.jpg,khoa_neo,1485,1340,1911,1544,1,426,204,1698,1442,0.41863905325443784,0.6324561403508772,0.10502958579881656,0.08947368421052632
DJI_0400.JPG,228.jpg,khoa_neo,1737,1056,2090,1252,1,353,196,1913,1154,0.47164694280078895,0.506140350877193,0.08703155818540434,0.08596491228070176
DJI_0401.JPG,229.jpg,tru_su,2383,694,3369,1211,2,986,517,2876,952,0.7090729783037475,0.41754385964912283,0.24309664694280078,0.2267543859649123
DJI_0401.JPG,229.jpg,tru_su,2797,1395,3022,1683,2,225,288,2909,1539,0.7172090729783037,0.675,0.05547337278106509,0.12631578947368421
DJI_0401.JPG,229.jpg,tru_su,1527,1845,2144,2241,2,617,396,1835,2043,0.45241617357001973,0.8960526315789473,0.15212031558185404,0.1736842105263158
DJI_0401.JPG,229.jpg,tru_su,18,935,487,1159,2,469,224,252,1047,0.0621301775147929,0.45921052631578946,0.11563116370808678,0.09824561403508772
DJI_0401.JPG,229.jpg,tru_su,1101,336,1251,494,2,150,158,1176,415,0.28994082840236685,0.18201754385964913,0.03698224852071006,0.06929824561403508
DJI_0401.JPG,229.jpg,khoa_neo,1330,1375,1718,1570,1,388,195,1524,1472,0.3757396449704142,0.6456140350877193,0.09566074950690336,0.08552631578947369
DJI_0401.JPG,229.jpg,khoa_neo,1629,1117,1943,1269,1,314,152,1786,1193,0.4403353057199211,0.5232456140350877,0.07741617357001973,0.06666666666666667
DJI_0401.JPG,229.jpg,khoa_neo,2439,702,2489,791,1,50,89,2464,746,0.6074950690335306,0.32719298245614037,0.01232741617357002,0.03903508771929825
DJI_0401.JPG,229.jpg,tru_su,2461,2018,2688,2248,2,227,230,2574,2133,0.6346153846153846,0.9355263157894737,0.05596646942800789,0.10087719298245613
DJI_0402.JPG,230.jpg,tru_su,2151,709,3171,1280,2,1020,571,2661,994,0.6560650887573964,0.4359649122807018,0.2514792899408284,0.25043859649122807
DJI_0402.JPG,230.jpg,tru_su,2707,1405,2933,1689,2,226,284,2820,1547,0.6952662721893491,0.6785087719298246,0.05571992110453649,0.12456140350877193
DJI_0402.JPG,230.jpg,tru_su,2369,2022,2588,2241,2,219,219,2478,2131,0.6109467455621301,0.9346491228070175,0.053994082840236685,0.09605263157894736
DJI_0402.JPG,230.jpg,tru_su,1418,1870,2047,2264,2,629,394,1732,2067,0.4270216962524655,0.906578947368421,0.15507889546351084,0.17280701754385966
DJI_0402.JPG,230.jpg,tru_su,5,942,410,1163,2,405,221,207,1052,0.05103550295857988,0.4614035087719298,0.09985207100591716,0.0969298245614035
DJI_0402.JPG,230.jpg,tru_su,1052,348,1190,500,2,138,152,1121,424,0.27638067061143984,0.18596491228070175,0.034023668639053255,0.06666666666666667
DJI_0402.JPG,230.jpg,khoa_neo,1130,1397,1512,1566,1,382,169,1321,1481,0.32569033530571995,0.6495614035087719,0.09418145956607495,0.07412280701754385
DJI_0402.JPG,230.jpg,khoa_neo,1424,1134,1749,1270,1,325,136,1586,1202,0.391025641025641,0.5271929824561403,0.08012820512820513,0.05964912280701754
DJI_0403.JPG,231.jpg,tru_su,2828,1393,3124,1720,2,296,327,2976,1556,0.7337278106508875,0.6824561403508772,0.07297830374753451,0.14342105263157895
DJI_0403.JPG,231.jpg,tru_su,1304,1952,2063,2280,2,759,328,1683,2116,0.41494082840236685,0.9280701754385965,0.1871301775147929,0.14385964912280702
DJI_0403.JPG,231.jpg,tru_su,2,876,180,1017,2,178,141,91,946,0.022435897435897436,0.4149122807017544,0.04388560157790927,0.06184210526315789
DJI_0403.JPG,231.jpg,tru_su,2281,361,3744,1200,2,1463,839,3012,780,0.742603550295858,0.34210526315789475,0.36070019723865876,0.36798245614035086
DJI_0403.JPG,231.jpg,tru_su,2488,2156,2715,2280,2,227,124,2601,2218,0.6412721893491125,0.9728070175438597,0.05596646942800789,0.054385964912280704
DJI_0403.JPG,231.jpg,khoa_neo,559,1384,1179,1617,1,620,233,869,1500,0.21425049309664695,0.6578947368421053,0.15285996055226825,0.10219298245614035
DJI_0403.JPG,231.jpg,khoa_neo,1071,976,1641,1159,1,570,183,1356,1067,0.3343195266272189,0.4679824561403509,0.14053254437869822,0.08026315789473684
DJI_0404.JPG,232.jpg,tru_su,3170,1454,3497,1796,2,327,342,3333,1625,0.8217455621301775,0.7127192982456141,0.08062130177514792,0.15
DJI_0404.JPG,232.jpg,tru_su,1500,1881,2284,2276,2,784,395,1892,2078,0.46646942800788954,0.9114035087719298,0.1932938856015779,0.17324561403508773
DJI_0404.JPG,232.jpg,tru_su,69,636,588,836,2,519,200,328,736,0.08086785009861933,0.32280701754385965,0.1279585798816568,0.08771929824561403
DJI_0404.JPG,232.jpg,tru_su,2683,259,4049,986,2,1366,727,3366,622,0.8298816568047337,0.27280701754385966,0.33678500986193294,0.318859649122807
DJI_0404.JPG,232.jpg,khoa_neo,865,980,1606,1264,1,741,284,1235,1122,0.30448717948717946,0.4921052631578947,0.18269230769230768,0.12456140350877193
DJI_0404.JPG,232.jpg,khoa_neo,1435,636,1931,889,1,496,253,1683,762,0.41494082840236685,0.33421052631578946,0.1222879684418146,0.11096491228070175
DJI_0404.JPG,232.jpg,tru_su,2940,918,3177,1110,2,237,192,3058,1014,0.7539447731755424,0.44473684210526315,0.058431952662721894,0.08421052631578947
DJI_0405.JPG,233.jpg,tru_su,1573,1847,2319,2278,2,746,431,1946,2062,0.4797830374753452,0.9043859649122807,0.1839250493096647,0.18903508771929825
DJI_0405.JPG,233.jpg,tru_su,3140,1435,3527,1797,2,387,362,3333,1616,0.8217455621301775,0.7087719298245614,0.09541420118343195,0.1587719298245614
DJI_0405.JPG,233.jpg,tru_su,69,620,585,809,2,516,189,327,714,0.08062130177514792,0.3131578947368421,0.12721893491124261,0.08289473684210526
DJI_0405.JPG,233.jpg,tru_su,2699,193,4049,977,2,1350,784,3374,585,0.8318540433925049,0.2565789473684211,0.3328402366863905,0.34385964912280703
DJI_0405.JPG,233.jpg,khoa_neo,831,914,1738,1227,1,907,313,1284,1070,0.3165680473372781,0.4692982456140351,0.22361932938856016,0.13728070175438598
DJI_0405.JPG,233.jpg,khoa_neo,1454,607,1960,861,1,506,254,1707,734,0.4208579881656805,0.3219298245614035,0.1247534516765286,0.11140350877192982
DJI_0405.JPG,233.jpg,tru_su,2935,886,3199,1102,2,264,216,3067,994,0.756163708086785,0.4359649122807018,0.0650887573964497,0.09473684210526316
DJI_0405.JPG,233.jpg,tru_su,2779,2159,3019,2277,2,240,118,2899,2218,0.7147435897435898,0.9728070175438597,0.05917159763313609,0.05175438596491228
DJI_0406.JPG,234.jpg,tru_su,1569,1943,2315,2280,2,746,337,1942,2111,0.47879684418145957,0.9258771929824562,0.1839250493096647,0.14780701754385964
DJI_0406.JPG,234.jpg,tru_su,3119,1510,3527,1835,2,408,325,3323,1672,0.8192800788954635,0.7333333333333333,0.10059171597633136,0.1425438596491228
DJI_0406.JPG,234.jpg,tru_su,123,685,644,868,2,521,183,383,776,0.09442800788954635,0.34035087719298246,0.1284516765285996,0.08026315789473684
DJI_0406.JPG,234.jpg,tru_su,2727,422,4044,1172,2,1317,750,3385,797,0.8345660749506904,0.3495614035087719,0.32470414201183434,0.32894736842105265
DJI_0406.JPG,234.jpg,khoa_neo,994,1189,1752,1410,1,758,221,1373,1299,0.3385108481262327,0.5697368421052632,0.1868836291913215,0.0969298245614035
DJI_0406.JPG,234.jpg,khoa_neo,1532,860,2007,1039,1,475,179,1769,949,0.4361439842209073,0.4162280701754386,0.11711045364891519,0.07850877192982456
DJI_0407.JPG,235.jpg,tru_su,77,710,619,902,2,542,192,348,806,0.08579881656804733,0.35350877192982455,0.133629191321499,0.08421052631578947
DJI_0407.JPG,235.jpg,tru_su,2690,477,4044,1172,2,1354,695,3367,824,0.8301282051282052,0.36140350877192984,0.3338264299802761,0.3048245614035088
DJI_0407.JPG,235.jpg,tru_su,3132,1531,3473,1872,2,341,341,3302,1701,0.8141025641025641,0.7460526315789474,0.08407297830374753,0.14956140350877192
DJI_0407.JPG,235.jpg,tru_su,1569,1960,2273,2269,2,704,309,1921,2114,0.47361932938856016,0.9271929824561403,0.17357001972386588,0.1355263157894737
DJI_0407.JPG,235.jpg,khoa_neo,936,1285,1561,1481,1,625,196,1248,1383,0.3076923076923077,0.6065789473684211,0.15409270216962526,0.08596491228070176
DJI_0407.JPG,235.jpg,khoa_neo,1527,881,1957,1081,1,430,200,1742,981,0.42948717948717946,0.43026315789473685,0.10601577909270217,0.08771929824561403
DJI_0408.JPG,236.jpg,tru_su,273,410,1665,835,2,1392,425,969,622,0.23890532544378698,0.27280701754385966,0.3431952662721893,0.18640350877192982
DJI_0408.JPG,236.jpg,tru_su,2394,647,2798,1543,2,404,896,2596,1095,0.6400394477317555,0.48026315789473684,0.09960552268244575,0.3929824561403509
DJI_0408.JPG,236.jpg,tru_su,3023,381,3452,1118,2,429,737,3237,749,0.7980769230769231,0.3285087719298246,0.10576923076923077,0.3232456140350877
DJI_0408.JPG,236.jpg,tru_su,3148,1902,3527,2273,2,379,371,3337,2087,0.8227317554240631,0.9153508771929825,0.09344181459566075,0.16271929824561404
DJI_0408.JPG,236.jpg,tru_su,15,1289,148,1393,2,133,104,81,1341,0.019970414201183433,0.5881578947368421,0.03279092702169625,0.0456140350877193
DJI_0408.JPG,236.jpg,tru_su,846,883,1111,1054,2,265,171,978,968,0.2411242603550296,0.4245614035087719,0.0653353057199211,0.075
DJI_0408.JPG,236.jpg,tru_su,2526,59,2893,194,2,367,135,2709,126,0.6678994082840237,0.05526315789473684,0.09048323471400395,0.05921052631578947
DJI_0409.JPG,237.jpg,tru_su,2002,435,2407,1385,2,405,950,2204,910,0.5433925049309665,0.3991228070175439,0.09985207100591716,0.4166666666666667
DJI_0409.JPG,237.jpg,tru_su,2552,156,2936,918,2,384,762,2744,537,0.6765285996055227,0.2355263157894737,0.09467455621301775,0.33421052631578946
DJI_0409.JPG,237.jpg,tru_su,2727,1706,3169,2169,2,442,463,2948,1937,0.7268244575936884,0.849561403508772,0.10897435897435898,0.20307017543859648
DJI_0409.JPG,237.jpg,tru_su,19,218,1140,647,2,1121,429,579,432,0.14275147928994084,0.18947368421052632,0.27638067061143984,0.1881578947368421
DJI_0409.JPG,237.jpg,tru_su,352,881,607,1043,2,255,162,479,962,0.1180966469428008,0.4219298245614035,0.0628698224852071,0.07105263157894737
DJI_0409.JPG,237.jpg,khoa_neo,2628,1483,2718,1650,1,90,167,2673,1566,0.6590236686390533,0.6868421052631579,0.022189349112426034,0.07324561403508772
DJI_0410.JPG,238.jpg,tru_su,2,285,1044,722,2,1042,437,523,503,0.1289447731755424,0.2206140350877193,0.2569033530571992,0.19166666666666668
DJI_0410.JPG,238.jpg,tru_su,1894,497,2298,1402,2,404,905,2096,949,0.5167652859960552,0.4162280701754386,0.09960552268244575,0.3969298245614035
DJI_0410.JPG,238.jpg,tru_su,2465,222,2786,935,2,321,713,2625,578,0.647189349112426,0.2535087719298246,0.07914201183431953,0.312719298245614
DJI_0410.JPG,238.jpg,tru_su,2627,1706,3061,2173,2,434,467,2844,1939,0.7011834319526628,0.8504385964912281,0.10700197238658778,0.20482456140350877
DJI_0410.JPG,238.jpg,tru_su,198,914,482,1102,2,284,188,340,1008,0.08382642998027613,0.4421052631578947,0.07001972386587771,0.0824561403508772
DJI_0410.JPG,238.jpg,khoa_neo,2535,1493,2613,1650,1,78,157,2574,1571,0.6346153846153846,0.6890350877192982,0.019230769230769232,0.06885964912280702
DJI_0411.JPG,239.jpg,tru_su,7,614,1019,964,2,1012,350,513,789,0.1264792899408284,0.3460526315789474,0.2495069033530572,0.15350877192982457
DJI_0411.JPG,239.jpg,tru_su,1902,777,2315,1727,2,413,950,2108,1252,0.519723865877712,0.5491228070175439,0.10182445759368837,0.4166666666666667
DJI_0411.JPG,239.jpg,tru_su,2490,647,2777,1377,2,287,730,2633,1012,0.6491617357001972,0.443859649122807,0.07075936883629191,0.3201754385964912
DJI_0411.JPG,239.jpg,tru_su,152,1527,419,1702,2,267,175,285,1614,0.07026627218934911,0.7078947368421052,0.06582840236686391,0.07675438596491228
DJI_0412.JPG,240.jpg,tru_su,1873,847,2273,1881,2,400,1034,2073,1364,0.511094674556213,0.5982456140350877,0.09861932938856016,0.4535087719298246
DJI_0412.JPG,240.jpg,tru_su,2481,856,2747,1648,2,266,792,2614,1252,0.6444773175542406,0.5491228070175439,0.0655818540433925,0.3473684210526316
DJI_0412.JPG,240.jpg,tru_su,7,739,1036,956,2,1029,217,521,847,0.1284516765285996,0.3714912280701754,0.253698224852071,0.09517543859649123
DJI_0412.JPG,240.jpg,tru_su,72,2046,359,2215,2,287,169,215,2130,0.053007889546351085,0.9342105263157895,0.07075936883629191,0.07412280701754385
DJI_0412.JPG,240.jpg,tru_su,2,989,61,1270,2,59,281,31,1129,0.007642998027613412,0.4951754385964912,0.014546351084812623,0.12324561403508771
DJI_0413.JPG,241.jpg,tru_su,19,360,982,614,2,963,254,500,487,0.1232741617357002,0.21359649122807017,0.23742603550295857,0.11140350877192982
DJI_0413.JPG,241.jpg,tru_su,1894,464,2298,1522,2,404,1058,2096,993,0.5167652859960552,0.4355263157894737,0.09960552268244575,0.46403508771929824
DJI_0413.JPG,241.jpg,tru_su,2473,635,2773,1414,2,300,779,2623,1024,0.6466962524654832,0.44912280701754387,0.07396449704142012,0.3416666666666667
DJI_0413.JPG,241.jpg,tru_su,283,773,624,925,2,341,152,453,849,0.11168639053254438,0.37236842105263157,0.08407297830374753,0.06666666666666667
DJI_0413.JPG,241.jpg,tru_su,1,813,69,1085,2,68,272,35,949,0.008629191321499015,0.4162280701754386,0.016765285996055226,0.11929824561403508
DJI_0414.JPG,242.jpg,tru_su,15,431,1198,639,2,1183,208,606,535,0.14940828402366865,0.23464912280701755,0.2916666666666667,0.0912280701754386
DJI_0414.JPG,242.jpg,tru_su,2015,435,2440,1531,2,425,1096,2227,983,0.5490631163708086,0.431140350877193,0.10478303747534516,0.4807017543859649
DJI_0414.JPG,242.jpg,tru_su,2723,602,3027,1406,2,304,804,2875,1004,0.7088264299802761,0.44035087719298244,0.07495069033530571,0.3526315789473684
DJI_0414.JPG,242.jpg,tru_su,411,839,498,1206,2,87,367,454,1022,0.11193293885601578,0.4482456140350877,0.021449704142011833,0.16096491228070176
DJI_0414.JPG,242.jpg,tru_su,2198,647,2494,885,2,296,238,2346,766,0.5784023668639053,0.33596491228070174,0.07297830374753451,0.10438596491228071
DJI_0414.JPG,242.jpg,tru_su,677,756,1048,931,2,371,175,862,843,0.21252465483234714,0.36973684210526314,0.09146942800788954,0.07675438596491228
DJI_0415.JPG,243.jpg,tru_su,2877,577,3177,1452,2,300,875,3027,1014,0.746301775147929,0.44473684210526315,0.07396449704142012,0.38377192982456143
DJI_0415.JPG,243.jpg,tru_su,2127,443,2515,1547,2,388,1104,2321,995,0.5722386587771203,0.43640350877192985,0.09566074950690336,0.4842105263157895
DJI_0415.JPG,243.jpg,tru_su,2523,656,2652,877,2,129,221,2587,766,0.6378205128205128,0.33596491228070174,0.031804733727810654,0.0969298245614035
DJI_0415.JPG,243.jpg,tru_su,1,418,1302,681,2,1301,263,651,549,0.16050295857988164,0.24078947368421053,0.3207593688362919,0.11535087719298245
DJI_0415.JPG,243.jpg,tru_su,627,831,715,1202,2,88,371,671,1016,0.16543392504930968,0.4456140350877193,0.021696252465483234,0.16271929824561404
DJI_0415.JPG,243.jpg,tru_su,977,793,1240,939,2,263,146,1108,866,0.27317554240631164,0.3798245614035088,0.0648422090729783,0.06403508771929825
DJI_0416.JPG,244.jpg,tru_su,1973,722,2323,931,2,350,209,2148,826,0.5295857988165681,0.362280701754386,0.08629191321499013,0.09166666666666666
DJI_0416.JPG,244.jpg,tru_su,2344,727,2636,1527,2,292,800,2490,1127,0.613905325443787,0.49429824561403507,0.07199211045364892,0.3508771929824561
DJI_0416.JPG,244.jpg,tru_su,1365,627,1744,1681,2,379,1054,1554,1154,0.3831360946745562,0.506140350877193,0.09344181459566075,0.46228070175438596
DJI_0416.JPG,244.jpg,tru_su,11,560,702,777,2,691,217,356,668,0.08777120315581854,0.2929824561403509,0.17036489151873768,0.09517543859649123
DJI_0416.JPG,244.jpg,tru_su,782,856,1111,968,2,329,112,946,912,0.23323471400394477,0.4,0.08111439842209073,0.04912280701754386
DJI_0417.JPG,245.jpg,tru_su,1,652,1148,914,2,1147,262,574,783,0.14151873767258383,0.34342105263157896,0.2827909270216962,0.11491228070175438
DJI_0417.JPG,245.jpg,tru_su,2444,773,2777,973,2,333,200,2610,873,0.643491124260355,0.3828947368421053,0.08210059171597633,0.08771929824561403
DJI_0417.JPG,245.jpg,tru_su,2840,739,3169,1606,2,329,867,3004,1172,0.7406311637080868,0.5140350877192983,0.08111439842209073,0.38026315789473686
DJI_0417.JPG,245.jpg,tru_su,1827,764,2194,1760,2,367,996,2010,1262,0.49556213017751477,0.5535087719298246,0.09048323471400395,0.4368421052631579
DJI_0417.JPG,245.jpg,tru_su,7,2157,261,2261,2,254,104,134,2209,0.033037475345167655,0.968859649122807,0.0626232741617357,0.0456140350877193
DJI_0417.JPG,245.jpg,tru_su,1286,897,1540,985,2,254,88,1413,941,0.34837278106508873,0.41271929824561404,0.0626232741617357,0.03859649122807018
DJI_0418.JPG,246.jpg,tru_su,136,685,1390,931,2,1254,246,763,808,0.1881163708086785,0.3543859649122807,0.3091715976331361,0.10789473684210527
DJI_0418.JPG,246.jpg,tru_su,15,2107,490,2240,2,475,133,252,2173,0.0621301775147929,0.9530701754385965,0.11711045364891519,0.058333333333333334
DJI_0418.JPG,246.jpg,tru_su,2640,764,2965,985,2,325,221,2802,874,0.6908284023668639,0.38333333333333336,0.08012820512820513,0.0969298245614035
DJI_0418.JPG,246.jpg,tru_su,3040,743,3402,1631,2,362,888,3221,1187,0.7941321499013807,0.5206140350877193,0.08925049309664694,0.3894736842105263
DJI_0418.JPG,246.jpg,tru_su,2044,706,2448,1781,2,404,1075,2246,1243,0.5537475345167653,0.5451754385964912,0.09960552268244575,0.47149122807017546
DJI_0418.JPG,246.jpg,tru_su,1127,939,1198,1327,2,71,388,1162,1133,0.2864891518737673,0.4969298245614035,0.017504930966469427,0.17017543859649123
