prev_filename,filename,strType,xmin,ymin,xmax,ymax,labels,width,height,x_center,y_center,x_center_norm,y_center_norm,w_norm,h_norm
DJI_0164.JPG,0.jpg,ong_noi,1617,1345,2124,1472,0,507,127,1870,1408,0.46104536489151876,0.6175438596491228,0.125,0.05570175438596491
DJI_0165.JPG,1.jpg,ong_noi,1748,1283,2460,1466,0,712,183,2104,1374,0.5187376725838264,0.6026315789473684,0.1755424063116371,0.08026315789473684
DJI_0166.JPG,2.jpg,ong_noi,1496,1216,2132,1335,0,636,119,1814,1275,0.4472386587771203,0.5592105263157895,0.15680473372781065,0.052192982456140354
DJI_0166.JPG,2.jpg,ong_noi,3542,1615,3682,1660,0,140,45,3612,1637,0.8905325443786982,0.7179824561403508,0.03451676528599606,0.019736842105263157
DJI_0167.JPG,3.jpg,ong_noi,1825,1451,2477,1693,0,652,242,2151,1572,0.5303254437869822,0.6894736842105263,0.16074950690335305,0.10614035087719298
DJI_0167.JPG,3.jpg,ong_noi,2709,1510,2824,1559,0,115,49,2766,1534,0.6819526627218935,0.6728070175438596,0.028353057199211044,0.02149122807017544
DJI_0168.JPG,4.jpg,ong_noi,1816,1089,2400,1320,0,584,231,2108,1204,0.519723865877712,0.5280701754385965,0.14398422090729784,0.1013157894736842
DJI_0168.JPG,4.jpg,ong_noi,2988,1759,3142,1843,0,154,84,3065,1801,0.7556706114398422,0.7899122807017543,0.03796844181459566,0.03684210526315789
DJI_0169.JPG,5.jpg,ong_noi,1624,1042,2138,1270,0,514,228,1881,1156,0.46375739644970415,0.5070175438596491,0.1267258382642998,0.1
DJI_0169.JPG,5.jpg,ong_noi,2810,1713,2930,1790,0,120,77,2870,1751,0.7075936883629191,0.7679824561403509,0.029585798816568046,0.033771929824561404
DJI_0169.JPG,5.jpg,ong_noi,2468,922,2608,990,0,140,68,2538,956,0.6257396449704142,0.4192982456140351,0.03451676528599606,0.02982456140350877
DJI_0170.JPG,6.jpg,ong_noi,1406,1174,2050,1357,0,644,183,1728,1265,0.4260355029585799,0.5548245614035088,0.15877712031558186,0.08026315789473684
DJI_0170.JPG,6.jpg,ong_noi,3466,1144,3615,1187,0,149,43,3540,1165,0.8727810650887574,0.5109649122807017,0.03673570019723866,0.018859649122807017
DJI_0170.JPG,6.jpg,ong_noi,3676,2119,3840,2172,0,164,53,3758,2145,0.9265285996055227,0.9407894736842105,0.04043392504930966,0.02324561403508772
DJI_0171.JPG,7.jpg,ong_noi,1261,928,2319,1251,0,1058,323,1790,1089,0.4413214990138067,0.4776315789473684,0.2608481262327416,0.14166666666666666
DJI_0171.JPG,7.jpg,ong_noi,3699,1130,3913,1188,0,214,58,3806,1159,0.9383629191321499,0.5083333333333333,0.05276134122287968,0.02543859649122807
DJI_0171.JPG,7.jpg,ong_noi,3938,2194,4056,2264,0,118,70,3997,2229,0.9854536489151874,0.9776315789473684,0.029092702169625246,0.03070175438596491
DJI_0172.JPG,8.jpg,ong_noi,1981,816,2877,1053,0,896,237,2429,934,0.5988658777120316,0.40964912280701754,0.22090729783037474,0.10394736842105264
DJI_0172.JPG,8.jpg,ong_noi,3832,859,3988,911,0,156,52,3910,885,0.9640039447731755,0.3881578947368421,0.038461538461538464,0.02280701754385965
DJI_0172.JPG,8.jpg,ong_noi,3983,1897,4056,1964,0,73,67,4019,1930,0.9908777120315582,0.8464912280701754,0.01799802761341223,0.029385964912280703
DJI_0173.JPG,9.jpg,ong_noi,1340,995,2515,1214,0,1175,219,1927,1104,0.47509861932938857,0.4842105263157895,0.28969428007889547,0.09605263157894736
DJI_0174.JPG,10.jpg,ong_noi,1227,938,2411,1085,0,1184,147,1819,1011,0.4484714003944773,0.44342105263157894,0.29191321499013806,0.06447368421052632
DJI_0175.JPG,11.jpg,ong_noi,1328,1068,2416,1285,0,1088,217,1872,1176,0.46153846153846156,0.5157894736842106,0.2682445759368836,0.09517543859649123
DJI_0176.JPG,12.jpg,ong_noi,1436,1257,2548,1506,0,1112,249,1992,1381,0.4911242603550296,0.605701754385965,0.27416173570019725,0.10921052631578948
DJI_0177.JPG,13.jpg,ong_noi,1769,993,2907,1431,0,1138,438,2338,1212,0.5764299802761341,0.531578947368421,0.28057199211045364,0.19210526315789472
DJI_0177.JPG,13.jpg,ong_noi,1748,2095,1956,2190,0,208,95,1852,2142,0.45660749506903353,0.9394736842105263,0.05128205128205128,0.041666666666666664
DJI_0178.JPG,14.jpg,ong_noi,1719,1047,2986,1552,0,1267,505,2352,1299,0.5798816568047337,0.5697368421052632,0.3123767258382643,0.22149122807017543
DJI_0178.JPG,14.jpg,ong_noi,1861,2082,2080,2195,0,219,113,1970,2138,0.48570019723865876,0.9377192982456141,0.053994082840236685,0.04956140350877193
DJI_0179.JPG,15.jpg,ong_noi,1605,623,2392,1054,0,787,431,1998,838,0.492603550295858,0.3675438596491228,0.1940335305719921,0.18903508771929825
DJI_0179.JPG,15.jpg,ong_noi,2151,1997,2319,2114,0,168,117,2235,2055,0.5510355029585798,0.9013157894736842,0.04142011834319527,0.05131578947368421
DJI_0180.JPG,16.jpg,ong_noi,1717,1018,2532,1485,0,815,467,2124,1251,0.5236686390532544,0.5486842105263158,0.20093688362919132,0.20482456140350877
DJI_0180.JPG,16.jpg,ong_noi,2170,2051,2354,2177,0,184,126,2262,2114,0.5576923076923077,0.9271929824561403,0.045364891518737675,0.05526315789473684
DJI_0181.JPG,17.jpg,ong_noi,1711,778,2577,1177,0,866,399,2144,977,0.5285996055226825,0.42850877192982456,0.21351084812623275,0.175
DJI_0181.JPG,17.jpg,ong_noi,2171,2013,2344,2141,0,173,128,2257,2077,0.5564595660749507,0.9109649122807018,0.04265285996055227,0.056140350877192984
DJI_0182.JPG,18.jpg,ong_noi,1923,744,2595,1223,0,672,479,2259,983,0.5569526627218935,0.431140350877193,0.16568047337278108,0.2100877192982456
DJI_0182.JPG,18.jpg,ong_noi,1918,476,2027,543,0,109,67,1972,509,0.48619329388560156,0.22324561403508772,0.02687376725838264,0.029385964912280703
DJI_0182.JPG,18.jpg,ong_noi,2602,2092,2772,2243,0,170,151,2687,2167,0.6624753451676528,0.9504385964912281,0.041913214990138066,0.0662280701754386
DJI_0183.JPG,19.jpg,ong_noi,1866,319,2693,764,0,827,445,2279,541,0.5618836291913215,0.23728070175438595,0.2038954635108481,0.19517543859649122
DJI_0183.JPG,19.jpg,ong_noi,1903,421,2017,490,0,114,69,1960,455,0.4832347140039448,0.19956140350877194,0.028106508875739646,0.030263157894736843
DJI_0183.JPG,19.jpg,ong_noi,2614,2058,2781,2219,0,167,161,2697,2138,0.6649408284023669,0.9377192982456141,0.04117357001972387,0.0706140350877193
DJI_0184.JPG,20.jpg,ong_noi,1887,668,2342,969,0,455,301,2114,818,0.5212031558185405,0.3587719298245614,0.11217948717948718,0.13201754385964912
DJI_0184.JPG,20.jpg,ong_noi,1907,478,2011,546,0,104,68,1959,512,0.48298816568047337,0.22456140350877193,0.02564102564102564,0.02982456140350877
DJI_0184.JPG,20.jpg,ong_noi,2544,1960,2682,2083,0,138,123,2613,2021,0.6442307692307693,0.8864035087719299,0.034023668639053255,0.05394736842105263
DJI_0185.JPG,21.jpg,ong_noi,1958,1090,2356,1421,0,398,331,2157,1255,0.5318047337278107,0.5504385964912281,0.09812623274161736,0.14517543859649124
DJI_0185.JPG,21.jpg,ong_noi,1948,585,2043,649,0,95,64,1995,617,0.4918639053254438,0.2706140350877193,0.02342209072978304,0.028070175438596492
DJI_0186.JPG,22.jpg,ong_noi,1681,1067,2062,1414,0,381,347,1871,1240,0.46129191321499013,0.543859649122807,0.09393491124260354,0.15219298245614035
DJI_0186.JPG,22.jpg,ong_noi,1890,587,1981,651,0,91,64,1935,619,0.4770710059171598,0.27149122807017545,0.022435897435897436,0.028070175438596492
DJI_0186.JPG,22.jpg,ong_noi,2469,2031,2605,2175,0,136,144,2537,2103,0.6254930966469427,0.9223684210526316,0.03353057199211045,0.06315789473684211
DJI_0187.JPG,23.jpg,ong_noi,1579,845,2077,1368,0,498,523,1828,1106,0.45069033530571995,0.4850877192982456,0.1227810650887574,0.2293859649122807
DJI_0187.JPG,23.jpg,ong_noi,2419,1481,2576,1632,0,157,151,2497,1556,0.6156311637080868,0.6824561403508772,0.038708086785009865,0.0662280701754386
DJI_0188.JPG,24.jpg,ong_noi,1909,690,2255,1133,0,346,443,2082,911,0.5133136094674556,0.39956140350877195,0.08530571992110454,0.19429824561403508
DJI_0188.JPG,24.jpg,ong_noi,2698,1513,2826,1671,0,128,158,2762,1592,0.6809664694280079,0.6982456140350877,0.03155818540433925,0.06929824561403508
DJI_0189.JPG,25.jpg,ong_noi,2081,665,2278,1239,0,197,574,2179,952,0.5372287968441815,0.41754385964912283,0.048570019723865876,0.2517543859649123
DJI_0189.JPG,25.jpg,ong_noi,3337,1883,3460,2087,0,123,204,3398,1985,0.8377712031558185,0.8706140350877193,0.030325443786982247,0.08947368421052632
DJI_0190.JPG,26.jpg,ong_noi,2036,556,2302,1315,0,266,759,2169,935,0.5347633136094675,0.4100877192982456,0.0655818540433925,0.33289473684210524
DJI_0191.JPG,27.jpg,ong_noi,2440,772,2898,1406,0,458,634,2669,1089,0.6580374753451677,0.4776315789473684,0.11291913214990137,0.27807017543859647
DJI_0192.JPG,28.jpg,ong_noi,2481,576,2831,1058,0,350,482,2656,817,0.6548323471400395,0.35833333333333334,0.08629191321499013,0.21140350877192982
DJI_0193.JPG,29.jpg,ong_noi,2280,853,2727,1327,0,447,474,2503,1090,0.6171104536489151,0.4780701754385965,0.11020710059171597,0.20789473684210527
DJI_0194.JPG,30.jpg,ong_noi,1640,914,2361,1460,0,721,546,2000,1187,0.4930966469428008,0.5206140350877193,0.17776134122287968,0.2394736842105263
DJI_0195.JPG,31.jpg,ong_noi,1807,875,2451,1289,0,644,414,2129,1082,0.5249013806706114,0.4745614035087719,0.15877712031558186,0.18157894736842106
DJI_0196.JPG,32.jpg,ong_noi,1552,977,2348,1285,0,796,308,1950,1131,0.4807692307692308,0.49605263157894736,0.19625246548323472,0.13508771929824562
DJI_0197.JPG,33.jpg,ong_noi,1902,964,2752,1189,0,850,225,2327,1076,0.5737179487179487,0.47192982456140353,0.20956607495069032,0.09868421052631579
DJI_0198.JPG,34.jpg,ong_noi,2243,1077,3202,1248,0,959,171,2722,1162,0.6711045364891519,0.5096491228070176,0.23643984220907296,0.075
DJI_0199.JPG,35.jpg,ong_noi,1936,1163,2844,1381,0,908,218,2390,1272,0.5892504930966469,0.5578947368421052,0.22386587771203156,0.0956140350877193
DJI_0200.JPG,36.jpg,ong_noi,1586,1264,2644,1522,0,1058,258,2115,1393,0.5214497041420119,0.6109649122807017,0.2608481262327416,0.11315789473684211
DJI_0201.JPG,37.jpg,ong_noi,1469,1252,2352,1581,0,883,329,1910,1416,0.47090729783037477,0.6210526315789474,0.21770216962524655,0.1442982456140351
DJI_0201.JPG,37.jpg,ong_noi,14,2083,219,2201,0,205,118,116,2142,0.028599605522682446,0.9394736842105263,0.05054240631163708,0.05175438596491228
DJI_0202.JPG,38.jpg,ong_noi,1675,1285,2478,1613,0,803,328,2076,1449,0.5118343195266272,0.6355263157894737,0.19797830374753453,0.14385964912280702
DJI_0202.JPG,38.jpg,ong_noi,164,1987,339,2103,0,175,116,251,2045,0.061883629191321496,0.8969298245614035,0.04314595660749507,0.05087719298245614
DJI_0203.JPG,39.jpg,ong_noi,1602,1268,2352,1714,0,750,446,1977,1491,0.4874260355029586,0.6539473684210526,0.1849112426035503,0.1956140350877193
DJI_0203.JPG,39.jpg,ong_noi,441,1780,571,1894,0,130,114,506,1837,0.1247534516765286,0.8057017543859649,0.03205128205128205,0.05
DJI_0204.JPG,40.jpg,ong_noi,1591,1078,2295,1499,0,704,421,1943,1288,0.47904339250493094,0.5649122807017544,0.17357001972386588,0.18464912280701753
DJI_0204.JPG,40.jpg,ong_noi,448,1517,591,1628,0,143,111,519,1572,0.1279585798816568,0.6894736842105263,0.035256410256410256,0.04868421052631579
DJI_0205.JPG,41.jpg,ong_noi,1739,1058,2314,1616,0,575,558,2026,1337,0.4995069033530572,0.5864035087719298,0.14176528599605523,0.24473684210526317
DJI_0205.JPG,41.jpg,ong_noi,941,1251,1044,1384,0,103,133,992,1317,0.2445759368836292,0.5776315789473684,0.025394477317554242,0.058333333333333334
DJI_0206.JPG,42.jpg,ong_noi,1565,918,1864,1601,0,299,683,1714,1259,0.42258382642998027,0.5521929824561403,0.07371794871794872,0.2995614035087719
DJI_0206.JPG,42.jpg,ong_noi,400,933,463,1116,0,63,183,431,1024,0.10626232741617357,0.44912280701754387,0.015532544378698224,0.08026315789473684
DJI_0207.JPG,43.jpg,ong_noi,2030,871,2257,1602,0,227,731,2143,1236,0.528353057199211,0.5421052631578948,0.05596646942800789,0.3206140350877193
DJI_0207.JPG,43.jpg,ong_noi,852,776,896,922,0,44,146,874,849,0.21548323471400394,0.37236842105263157,0.010848126232741617,0.06403508771929825
DJI_0207.JPG,43.jpg,ong_noi,1,167,89,331,0,88,164,45,249,0.011094674556213017,0.10921052631578948,0.021696252465483234,0.07192982456140351
DJI_0208.JPG,44.jpg,ong_noi,1839,992,1995,1633,0,156,641,1917,1312,0.47263313609467456,0.5754385964912281,0.038461538461538464,0.28114035087719297
DJI_0208.JPG,44.jpg,ong_noi,1123,694,1188,824,0,65,130,1155,759,0.28476331360946744,0.33289473684210524,0.016025641025641024,0.05701754385964912
DJI_0208.JPG,44.jpg,ong_noi,364,58,461,188,0,97,130,412,123,0.10157790927021697,0.05394736842105263,0.02391518737672584,0.05701754385964912
DJI_0209.JPG,45.jpg,ong_noi,1926,947,2218,1741,0,292,794,2072,1344,0.5108481262327417,0.5894736842105263,0.07199211045364892,0.3482456140350877
DJI_0209.JPG,45.jpg,ong_noi,1567,611,1650,756,0,83,145,1608,683,0.39644970414201186,0.2995614035087719,0.020463510848126233,0.06359649122807018
DJI_0210.JPG,46.jpg,ong_noi,1592,957,2194,1568,0,602,611,1893,1262,0.46671597633136097,0.5535087719298246,0.14842209072978305,0.2679824561403509
DJI_0210.JPG,46.jpg,ong_noi,2322,602,2425,710,0,103,108,2373,656,0.5850591715976331,0.28771929824561404,0.025394477317554242,0.04736842105263158
DJI_0210.JPG,46.jpg,ong_noi,3151,1310,3254,1469,0,103,159,3202,1389,0.789447731755424,0.6092105263157894,0.025394477317554242,0.06973684210526315
DJI_0211.JPG,47.jpg,ong_noi,1711,889,2502,1539,0,791,650,2106,1214,0.5192307692307693,0.5324561403508772,0.1950197238658777,0.2850877192982456
DJI_0211.JPG,47.jpg,ong_noi,2538,626,2673,736,0,135,110,2605,681,0.6422583826429981,0.2986842105263158,0.03328402366863906,0.04824561403508772
DJI_0211.JPG,47.jpg,ong_noi,3357,1411,3468,1558,0,111,147,3412,1484,0.8412228796844181,0.6508771929824562,0.027366863905325445,0.06447368421052632
DJI_0212.JPG,48.jpg,ong_noi,1808,825,2261,1176,0,453,351,2034,1000,0.5014792899408284,0.43859649122807015,0.11168639053254438,0.15394736842105264
DJI_0212.JPG,48.jpg,ong_noi,2498,630,2611,722,0,113,92,2554,676,0.6296844181459567,0.2964912280701754,0.027859960552268245,0.04035087719298246
DJI_0212.JPG,48.jpg,ong_noi,3237,1334,3336,1475,0,99,141,3286,1404,0.8101577909270217,0.6157894736842106,0.02440828402366864,0.06184210526315789
DJI_0212.JPG,48.jpg,ong_noi,3831,696,3911,799,0,80,103,3871,747,0.9543885601577909,0.32763157894736844,0.01972386587771203,0.04517543859649123
DJI_0213.JPG,49.jpg,ong_noi,1706,782,2242,1114,0,536,332,1974,948,0.48668639053254437,0.41578947368421054,0.13214990138067062,0.1456140350877193
DJI_0213.JPG,49.jpg,ong_noi,2985,752,3126,829,0,141,77,3055,790,0.7532051282051282,0.34649122807017546,0.03476331360946745,0.033771929824561404
DJI_0213.JPG,49.jpg,ong_noi,3603,1679,3741,1789,0,138,110,3672,1734,0.9053254437869822,0.7605263157894737,0.034023668639053255,0.04824561403508772
DJI_0214.JPG,50.jpg,ong_noi,1891,979,2480,1147,0,589,168,2185,1063,0.5387080867850098,0.4662280701754386,0.14521696252465482,0.07368421052631578
DJI_0214.JPG,50.jpg,ong_noi,3793,1202,4032,1273,0,239,71,3912,1237,0.9644970414201184,0.5425438596491228,0.0589250493096647,0.031140350877192982
DJI_0214.JPG,50.jpg,ong_noi,3849,239,4031,296,0,182,57,3940,267,0.9714003944773175,0.11710526315789474,0.04487179487179487,0.025
DJI_0214.JPG,50.jpg,ong_noi,963,1543,1222,1623,0,259,80,1092,1583,0.2692307692307692,0.6942982456140351,0.06385601577909271,0.03508771929824561
DJI_0215.JPG,51.jpg,ong_noi,1763,1157,2341,1297,0,578,140,2052,1227,0.5059171597633136,0.5381578947368421,0.14250493096646943,0.06140350877192982
DJI_0216.JPG,52.jpg,ong_noi,1755,1018,2767,1179,0,1012,161,2261,1098,0.5574457593688363,0.48157894736842105,0.2495069033530572,0.0706140350877193
DJI_0216.JPG,52.jpg,ong_noi,1127,1457,1359,1527,0,232,70,1243,1492,0.3064595660749507,0.6543859649122807,0.05719921104536489,0.03070175438596491
DJI_0217.JPG,53.jpg,ong_noi,1887,982,2944,1218,0,1057,236,2415,1100,0.5954142011834319,0.4824561403508772,0.26060157790927024,0.10350877192982456
DJI_0217.JPG,53.jpg,ong_noi,1231,1410,1490,1483,0,259,73,1360,1446,0.33530571992110453,0.6342105263157894,0.06385601577909271,0.032017543859649125
DJI_0218.JPG,54.jpg,ong_noi,1273,959,2506,1210,0,1233,251,1889,1084,0.46572978303747536,0.47543859649122805,0.3039940828402367,0.11008771929824561
DJI_0218.JPG,54.jpg,ong_noi,1170,1411,1402,1474,0,232,63,1286,1442,0.3170611439842209,0.6324561403508772,0.05719921104536489,0.02763157894736842
DJI_0219.JPG,55.jpg,ong_noi,1608,933,2622,1228,0,1014,295,2115,1080,0.5214497041420119,0.47368421052631576,0.25,0.12938596491228072
DJI_0219.JPG,55.jpg,ong_noi,1318,1354,1569,1430,0,251,76,1443,1392,0.3557692307692308,0.6105263157894737,0.061883629191321496,0.03333333333333333
DJI_0220.JPG,56.jpg,ong_noi,1552,935,2615,1339,0,1063,404,2083,1137,0.513560157790927,0.4986842105263158,0.2620808678500986,0.17719298245614035
DJI_0220.JPG,56.jpg,ong_noi,1430,1327,1639,1410,0,209,83,1534,1368,0.3782051282051282,0.6,0.05152859960552268,0.03640350877192983
DJI_0221.JPG,57.jpg,ong_noi,1626,1005,2668,1450,0,1042,445,2147,1227,0.5293392504930966,0.5381578947368421,0.2569033530571992,0.19517543859649122
DJI_0221.JPG,57.jpg,ong_noi,1596,1308,1820,1385,0,224,77,1708,1346,0.42110453648915186,0.5903508771929824,0.055226824457593686,0.033771929824561404
DJI_0222.JPG,58.jpg,ong_noi,1710,1095,2671,1580,0,961,485,2190,1337,0.5399408284023669,0.5864035087719298,0.23693293885601577,0.21271929824561403
DJI_0222.JPG,58.jpg,ong_noi,1808,1291,2004,1385,0,196,94,1906,1338,0.46992110453648916,0.5868421052631579,0.048323471400394474,0.0412280701754386
DJI_0223.JPG,59.jpg,ong_noi,1652,1160,2832,1781,0,1180,621,2242,1470,0.5527613412228797,0.6447368421052632,0.29092702169625245,0.2723684210526316
DJI_0224.JPG,60.jpg,ong_noi,1763,1133,2672,1770,0,909,637,2217,1451,0.5465976331360947,0.6364035087719299,0.22411242603550297,0.2793859649122807
DJI_0224.JPG,60.jpg,ong_noi,2104,1305,2281,1418,0,177,113,2192,1361,0.5404339250493096,0.5969298245614035,0.04363905325443787,0.04956140350877193
DJI_0225.JPG,61.jpg,ong_noi,1478,815,2456,1607,0,978,792,1967,1211,0.4849605522682446,0.531140350877193,0.2411242603550296,0.3473684210526316
DJI_0225.JPG,61.jpg,ong_noi,2205,1288,2379,1410,0,174,122,2292,1349,0.5650887573964497,0.5916666666666667,0.042899408284023666,0.05350877192982456
DJI_0226.JPG,62.jpg,ong_noi,1526,786,2451,1634,0,925,848,1988,1210,0.490138067061144,0.5307017543859649,0.22805719921104536,0.3719298245614035
DJI_0226.JPG,62.jpg,ong_noi,2360,1291,2537,1441,0,177,150,2448,1366,0.6035502958579881,0.5991228070175438,0.04363905325443787,0.06578947368421052
DJI_0227.JPG,63.jpg,ong_noi,1607,622,2627,1643,0,1020,1021,2117,1132,0.5219428007889546,0.4964912280701754,0.2514792899408284,0.44780701754385965
DJI_0227.JPG,63.jpg,ong_noi,2525,1323,2674,1462,0,149,139,2599,1392,0.6407790927021696,0.6105263157894737,0.03673570019723866,0.06096491228070176
DJI_0228.JPG,64.jpg,ong_noi,1865,1193,2794,2207,0,929,1014,2329,1700,0.5742110453648915,0.7456140350877193,0.22904339250493097,0.44473684210526315
DJI_0228.JPG,64.jpg,ong_noi,2532,1383,2708,1554,0,176,171,2620,1468,0.645956607495069,0.643859649122807,0.04339250493096647,0.075
DJI_0229.JPG,65.jpg,ong_noi,2008,973,2568,1527,0,560,554,2288,1250,0.5641025641025641,0.5482456140350878,0.13806706114398423,0.24298245614035088
DJI_0229.JPG,65.jpg,ong_noi,2498,1305,2667,1465,0,169,160,2582,1385,0.6365877712031558,0.6074561403508771,0.041666666666666664,0.07017543859649122
DJI_0230.JPG,66.jpg,ong_noi,2107,1001,2738,1436,0,631,435,2422,1218,0.5971400394477318,0.5342105263157895,0.15557199211045364,0.19078947368421054
DJI_0230.JPG,66.jpg,ong_noi,2276,1272,2428,1381,0,152,109,2352,1326,0.5798816568047337,0.5815789473684211,0.03747534516765286,0.04780701754385965
DJI_0231.JPG,67.jpg,ong_noi,1805,1019,2543,1366,0,738,347,2174,1192,0.5359960552268245,0.5228070175438596,0.1819526627218935,0.15219298245614035
DJI_0231.JPG,67.jpg,ong_noi,1875,1265,2047,1349,0,172,84,1961,1307,0.4834812623274162,0.5732456140350877,0.04240631163708087,0.03684210526315789
DJI_0232.JPG,68.jpg,ong_noi,1641,1033,2401,1319,0,760,286,2021,1176,0.4982741617357002,0.5157894736842106,0.1873767258382643,0.12543859649122807
DJI_0232.JPG,68.jpg,ong_noi,1649,1305,1785,1353,0,136,48,1717,1329,0.4233234714003945,0.5828947368421052,0.03353057199211045,0.021052631578947368
DJI_0233.JPG,69.jpg,ong_noi,1525,1050,2275,1289,0,750,239,1900,1169,0.46844181459566075,0.512719298245614,0.1849112426035503,0.10482456140350878
DJI_0233.JPG,69.jpg,ong_noi,1358,1347,1546,1418,0,188,71,1452,1382,0.35798816568047337,0.606140350877193,0.046351084812623275,0.031140350877192982
DJI_0234.JPG,70.jpg,ong_noi,1499,1133,2318,1280,0,819,147,1908,1206,0.47041420118343197,0.5289473684210526,0.20192307692307693,0.06447368421052632
DJI_0234.JPG,70.jpg,ong_noi,1150,1452,1326,1499,0,176,47,1238,1475,0.3052268244575937,0.6469298245614035,0.04339250493096647,0.0206140350877193
DJI_0235.JPG,71.jpg,ong_noi,1303,1141,2163,1326,0,860,185,1733,1233,0.4272682445759369,0.5407894736842105,0.21203155818540434,0.08114035087719298
DJI_0235.JPG,71.jpg,ong_noi,849,1582,1069,1637,0,220,55,959,1609,0.23643984220907296,0.7057017543859649,0.054240631163708086,0.02412280701754386
DJI_0236.JPG,72.jpg,ong_noi,1979,939,2743,1234,0,764,295,2361,1086,0.5821005917159763,0.4763157894736842,0.1883629191321499,0.12938596491228072
DJI_0236.JPG,72.jpg,ong_noi,697,1759,947,1844,0,250,85,822,1801,0.20266272189349113,0.7899122807017543,0.0616370808678501,0.03728070175438596
DJI_0236.JPG,72.jpg,ong_noi,3618,996,3783,1055,0,165,59,3700,1025,0.9122287968441815,0.44956140350877194,0.040680473372781065,0.02587719298245614
DJI_0237.JPG,73.jpg,ong_noi,1619,851,2372,1208,0,753,357,1995,1029,0.4918639053254438,0.4513157894736842,0.1856508875739645,0.15657894736842104
DJI_0237.JPG,73.jpg,ong_noi,3771,1778,3937,1913,0,166,135,3854,1845,0.9501972386587771,0.8092105263157895,0.040927021696252466,0.05921052631578947
DJI_0237.JPG,73.jpg,ong_noi,329,2020,575,2139,0,246,119,452,2079,0.11143984220907298,0.9118421052631579,0.060650887573964495,0.052192982456140354
DJI_0237.JPG,73.jpg,ong_noi,3088,769,3269,846,0,181,77,3178,807,0.7835305719921104,0.3539473684210526,0.04462524654832347,0.033771929824561404
DJI_0239.JPG,74.jpg,ong_noi,1680,875,2104,1134,0,424,259,1892,1004,0.46646942800788954,0.44035087719298244,0.10453648915187377,0.11359649122807018
DJI_0239.JPG,74.jpg,ong_noi,3331,1493,3463,1614,0,132,121,3397,1553,0.8375246548323472,0.6811403508771929,0.03254437869822485,0.05307017543859649
DJI_0239.JPG,74.jpg,ong_noi,369,2054,582,2187,0,213,133,475,2120,0.11711045364891519,0.9298245614035088,0.05251479289940828,0.058333333333333334
DJI_0240.JPG,75.jpg,ong_noi,1569,883,1942,1181,0,373,298,1755,1032,0.4326923076923077,0.45263157894736844,0.09196252465483234,0.1307017543859649
DJI_0240.JPG,75.jpg,ong_noi,3709,691,3787,804,0,78,113,3748,747,0.9240631163708086,0.32763157894736844,0.019230769230769232,0.04956140350877193
DJI_0240.JPG,75.jpg,ong_noi,3106,1343,3212,1461,0,106,118,3159,1402,0.7788461538461539,0.6149122807017544,0.026134122287968443,0.05175438596491228
DJI_0240.JPG,75.jpg,ong_noi,2412,646,2508,730,0,96,84,2460,688,0.606508875739645,0.3017543859649123,0.023668639053254437,0.03684210526315789
DJI_0241.JPG,76.jpg,ong_noi,1847,984,2376,1157,0,529,173,2111,1070,0.5204635108481263,0.4692982456140351,0.1304240631163708,0.07587719298245614
DJI_0241.JPG,76.jpg,ong_noi,3474,1047,3654,1101,0,180,54,3564,1074,0.878698224852071,0.4710526315789474,0.04437869822485207,0.02368421052631579
DJI_0241.JPG,76.jpg,ong_noi,821,1639,1048,1710,0,227,71,934,1674,0.23027613412228798,0.7342105263157894,0.05596646942800789,0.031140350877192982
DJI_0241.JPG,76.jpg,ong_noi,3897,2115,4056,2214,0,159,99,3976,2164,0.980276134122288,0.9491228070175438,0.03920118343195266,0.04342105263157895
DJI_0242.JPG,77.jpg,ong_noi,1713,1156,2265,1369,0,552,213,1989,1262,0.49038461538461536,0.5535087719298246,0.13609467455621302,0.09342105263157895
DJI_0242.JPG,77.jpg,ong_noi,1497,1325,1756,1396,0,259,71,1626,1360,0.40088757396449703,0.5964912280701754,0.06385601577909271,0.031140350877192982
DJI_0243.JPG,78.jpg,ong_noi,1495,1093,2020,1361,0,525,268,1757,1227,0.4331854043392505,0.5381578947368421,0.1294378698224852,0.11754385964912281
DJI_0243.JPG,78.jpg,ong_noi,1789,1280,1932,1361,0,143,81,1860,1320,0.45857988165680474,0.5789473684210527,0.035256410256410256,0.035526315789473684
DJI_0244.JPG,79.jpg,ong_noi,1551,1022,1980,1343,0,429,321,1765,1182,0.43515779092702167,0.5184210526315789,0.10576923076923077,0.14078947368421052
DJI_0244.JPG,79.jpg,ong_noi,2102,1255,2261,1373,0,159,118,2181,1314,0.5377218934911243,0.5763157894736842,0.03920118343195266,0.05175438596491228
DJI_0246.JPG,80.jpg,ong_noi,1774,995,2031,1436,0,257,441,1902,1215,0.46893491124260356,0.5328947368421053,0.0633629191321499,0.19342105263157894
DJI_0246.JPG,80.jpg,ong_noi,2794,1445,2929,1647,0,135,202,2861,1546,0.7053747534516766,0.6780701754385965,0.03328402366863906,0.08859649122807017
DJI_0247.JPG,81.jpg,ong_noi,1845,763,2072,1114,0,227,351,1958,938,0.482741617357002,0.4114035087719298,0.05596646942800789,0.15394736842105264
DJI_0247.JPG,81.jpg,ong_noi,2702,1324,2802,1479,0,100,155,2752,1401,0.6785009861932939,0.6144736842105263,0.02465483234714004,0.06798245614035088
DJI_0248.JPG,82.jpg,ong_noi,2101,811,2282,1136,0,181,325,2191,973,0.5401873767258383,0.4267543859649123,0.04462524654832347,0.1425438596491228
DJI_0248.JPG,82.jpg,ong_noi,2903,1406,2984,1549,0,81,143,2943,1477,0.7255917159763313,0.6478070175438596,0.019970414201183433,0.06271929824561404
DJI_0249.JPG,83.jpg,ong_noi,1729,855,1927,1131,0,198,276,1828,993,0.45069033530571995,0.4355263157894737,0.04881656804733728,0.12105263157894737
DJI_0249.JPG,83.jpg,ong_noi,2530,1292,2631,1422,0,101,130,2580,1357,0.636094674556213,0.5951754385964912,0.02490138067061144,0.05701754385964912
DJI_0250.JPG,84.jpg,ong_noi,1776,839,2033,1108,0,257,269,1904,973,0.46942800788954636,0.4267543859649123,0.0633629191321499,0.11798245614035088
DJI_0250.JPG,84.jpg,ong_noi,2343,1220,2468,1341,0,125,121,2405,1280,0.592948717948718,0.5614035087719298,0.03081854043392505,0.05307017543859649
DJI_0251.JPG,85.jpg,ong_noi,1574,847,1880,1109,0,306,262,1727,978,0.42578895463510846,0.42894736842105263,0.07544378698224852,0.11491228070175438
DJI_0251.JPG,85.jpg,ong_noi,2114,1192,2249,1300,0,135,108,2181,1246,0.5377218934911243,0.5464912280701755,0.03328402366863906,0.04736842105263158
DJI_0252.JPG,86.jpg,ong_noi,1878,864,2249,1047,0,371,183,2063,955,0.508629191321499,0.41885964912280704,0.09146942800788954,0.08026315789473684
DJI_0252.JPG,86.jpg,ong_noi,1940,1173,2090,1252,0,150,79,2015,1212,0.4967948717948718,0.531578947368421,0.03698224852071006,0.03464912280701754
DJI_0253.JPG,87.jpg,ong_noi,1824,878,2231,998,0,407,120,2027,938,0.4997534516765286,0.4114035087719298,0.10034516765285996,0.05263157894736842
DJI_0253.JPG,87.jpg,ong_noi,1420,1270,1604,1330,0,184,60,1512,1300,0.3727810650887574,0.5701754385964912,0.045364891518737675,0.02631578947368421
DJI_0254.JPG,88.jpg,ong_noi,1960,747,2319,882,0,359,135,2139,814,0.5273668639053254,0.3570175438596491,0.08851084812623274,0.05921052631578947
DJI_0254.JPG,88.jpg,ong_noi,3638,1798,3810,1893,0,172,95,3724,1845,0.9181459566074951,0.8092105263157895,0.04240631163708087,0.041666666666666664
DJI_0254.JPG,88.jpg,ong_noi,925,1550,1108,1609,0,183,59,1016,1579,0.2504930966469428,0.6925438596491228,0.045118343195266274,0.02587719298245614
DJI_0254.JPG,88.jpg,ong_noi,3133,106,3324,180,0,191,74,3228,143,0.7958579881656804,0.06271929824561404,0.04709072978303747,0.03245614035087719
DJI_0254.JPG,88.jpg,ong_noi,3252,903,3396,954,0,144,51,3324,928,0.8195266272189349,0.4070175438596491,0.03550295857988166,0.02236842105263158
DJI_0255.JPG,89.jpg,ong_noi,1865,737,2142,927,0,277,190,2003,832,0.493836291913215,0.3649122807017544,0.06829388560157791,0.08333333333333333
DJI_0255.JPG,89.jpg,ong_noi,3175,1320,3291,1429,0,116,109,3233,1374,0.7970907297830375,0.6026315789473684,0.028599605522682446,0.04780701754385965
DJI_0255.JPG,89.jpg,ong_noi,3810,775,3911,875,0,101,100,3860,825,0.9516765285996055,0.3618421052631579,0.02490138067061144,0.043859649122807015
DJI_0255.JPG,89.jpg,ong_noi,2578,633,2702,740,0,124,107,2640,686,0.650887573964497,0.30087719298245613,0.03057199211045365,0.04692982456140351
DJI_0256.JPG,90.jpg,ong_noi,1662,758,1876,1028,0,214,270,1769,893,0.4361439842209073,0.39166666666666666,0.05276134122287968,0.11842105263157894
DJI_0256.JPG,90.jpg,ong_noi,2581,1050,2655,1180,0,74,130,2618,1115,0.6454635108481263,0.48903508771929827,0.01824457593688363,0.05701754385964912
DJI_0256.JPG,90.jpg,ong_noi,2936,433,2990,523,0,54,90,2963,478,0.7305226824457594,0.20964912280701756,0.013313609467455622,0.039473684210526314
DJI_0256.JPG,90.jpg,ong_noi,1860,585,1940,698,0,80,113,1900,641,0.46844181459566075,0.28114035087719297,0.01972386587771203,0.04956140350877193
DJI_0257.JPG,91.jpg,ong_noi,1729,975,1974,1365,0,245,390,1851,1170,0.45636094674556216,0.5131578947368421,0.0604043392504931,0.17105263157894737
DJI_0257.JPG,91.jpg,ong_noi,2698,1136,2764,1277,0,66,141,2731,1206,0.6733234714003945,0.5289473684210526,0.016272189349112426,0.06184210526315789
DJI_0257.JPG,91.jpg,ong_noi,3048,450,3108,565,0,60,115,3078,507,0.7588757396449705,0.22236842105263158,0.014792899408284023,0.05043859649122807
DJI_0257.JPG,91.jpg,ong_noi,1902,619,1992,739,0,90,120,1947,679,0.48002958579881655,0.29780701754385963,0.022189349112426034,0.05263157894736842
DJI_0258.JPG,92.jpg,ong_noi,2047,997,2329,1340,0,282,343,2188,1168,0.539447731755424,0.512280701754386,0.0695266272189349,0.15043859649122807
DJI_0258.JPG,92.jpg,ong_noi,3051,1270,3137,1403,0,86,133,3094,1336,0.7628205128205128,0.5859649122807018,0.021203155818540435,0.058333333333333334
DJI_0258.JPG,92.jpg,ong_noi,3534,601,3592,699,0,58,98,3563,650,0.8784516765285996,0.2850877192982456,0.014299802761341223,0.04298245614035088
DJI_0258.JPG,92.jpg,ong_noi,2292,653,2388,738,0,96,85,2340,695,0.5769230769230769,0.3048245614035088,0.023668639053254437,0.03728070175438596
DJI_0259.JPG,93.jpg,ong_noi,1921,982,2301,1327,0,380,345,2111,1154,0.5204635108481263,0.506140350877193,0.09368836291913216,0.1513157894736842
DJI_0259.JPG,93.jpg,ong_noi,3194,1350,3285,1477,0,91,127,3239,1413,0.7985700197238659,0.6197368421052631,0.022435897435897436,0.05570175438596491
DJI_0259.JPG,93.jpg,ong_noi,3762,702,3836,804,0,74,102,3799,753,0.9366370808678501,0.33026315789473687,0.01824457593688363,0.04473684210526316
DJI_0259.JPG,93.jpg,ong_noi,2460,653,2565,744,0,105,91,2512,698,0.6193293885601578,0.306140350877193,0.025887573964497042,0.039912280701754385
DJI_0260.JPG,94.jpg,ong_noi,1823,1071,2254,1348,0,431,277,2038,1209,0.502465483234714,0.5302631578947369,0.10626232741617357,0.12149122807017544
DJI_0260.JPG,94.jpg,ong_noi,3392,1551,3513,1665,0,121,114,3452,1608,0.8510848126232742,0.7052631578947368,0.029832347140039447,0.05
DJI_0260.JPG,94.jpg,ong_noi,2736,737,2860,819,0,124,82,2798,778,0.6898422090729783,0.3412280701754386,0.03057199211045365,0.035964912280701755
DJI_0261.JPG,95.jpg,ong_noi,1768,1181,2289,1424,0,521,243,2028,1302,0.5,0.5710526315789474,0.1284516765285996,0.10657894736842105
DJI_0261.JPG,95.jpg,ong_noi,3605,1812,3752,1919,0,147,107,3678,1865,0.9068047337278107,0.8179824561403509,0.036242603550295856,0.04692982456140351
DJI_0261.JPG,95.jpg,ong_noi,2817,50,3033,155,0,216,105,2925,102,0.7211538461538461,0.04473684210526316,0.05325443786982249,0.046052631578947366
DJI_0261.JPG,95.jpg,ong_noi,552,1954,768,2055,0,216,101,660,2004,0.16272189349112426,0.8789473684210526,0.05325443786982249,0.04429824561403509
DJI_0261.JPG,95.jpg,ong_noi,3017,848,3201,957,0,184,109,3109,902,0.7665187376725838,0.3956140350877193,0.045364891518737675,0.04780701754385965
DJI_0262.JPG,96.jpg,ong_noi,1914,1250,2369,1481,0,455,231,2141,1365,0.5278599605522682,0.5986842105263158,0.11217948717948718,0.1013157894736842
DJI_0262.JPG,96.jpg,ong_noi,3172,153,3325,202,0,153,49,3248,177,0.8007889546351085,0.07763157894736843,0.03772189349112426,0.02149122807017544
DJI_0262.JPG,96.jpg,ong_noi,3794,2009,3935,2095,0,141,86,3864,2052,0.9526627218934911,0.9,0.03476331360946745,0.037719298245614034
DJI_0262.JPG,96.jpg,ong_noi,711,1843,926,1923,0,215,80,818,1883,0.20167652859960553,0.8258771929824561,0.053007889546351085,0.03508771929824561
DJI_0262.JPG,96.jpg,ong_noi,3281,984,3434,1054,0,153,70,3357,1019,0.8276627218934911,0.4469298245614035,0.03772189349112426,0.03070175438596491
DJI_0263.JPG,97.jpg,ong_noi,1902,1276,2473,1465,0,571,189,2187,1370,0.5392011834319527,0.6008771929824561,0.14077909270216962,0.08289473684210526
DJI_0263.JPG,97.jpg,ong_noi,3379,231,3577,273,0,198,42,3478,252,0.8574950690335306,0.11052631578947368,0.04881656804733728,0.018421052631578946
DJI_0263.JPG,97.jpg,ong_noi,3876,2164,4056,2270,0,180,106,3966,2217,0.977810650887574,0.9723684210526315,0.04437869822485207,0.04649122807017544
DJI_0263.JPG,97.jpg,ong_noi,829,1760,1042,1827,0,213,67,935,1793,0.23052268244575938,0.7864035087719298,0.05251479289940828,0.029385964912280703
DJI_0263.JPG,97.jpg,ong_noi,3469,1089,3630,1145,0,161,56,3549,1117,0.875,0.4899122807017544,0.039694280078895465,0.02456140350877193
DJI_0264.JPG,98.jpg,ong_noi,1744,1317,2280,1482,0,536,165,2012,1399,0.4960552268244576,0.6135964912280701,0.13214990138067062,0.07236842105263158
DJI_0264.JPG,98.jpg,ong_noi,3439,266,3672,341,0,233,75,3555,303,0.8764792899408284,0.13289473684210526,0.057445759368836294,0.03289473684210526
DJI_0264.JPG,98.jpg,ong_noi,826,1723,1032,1796,0,206,73,929,1759,0.22904339250493097,0.7714912280701754,0.050788954635108484,0.032017543859649125
DJI_0264.JPG,98.jpg,ong_noi,3514,1161,3691,1213,0,177,52,3602,1187,0.8880670611439843,0.5206140350877193,0.04363905325443787,0.02280701754385965
DJI_0265.JPG,99.jpg,ong_noi,1769,1297,2370,1451,0,601,154,2069,1374,0.5101084812623274,0.6026315789473684,0.14817554240631164,0.06754385964912281
DJI_0265.JPG,99.jpg,ong_noi,3750,373,3951,424,0,201,51,3850,398,0.9492110453648915,0.17456140350877192,0.04955621301775148,0.02236842105263158
DJI_0265.JPG,99.jpg,ong_noi,945,1630,1193,1686,0,248,56,1069,1658,0.263560157790927,0.7271929824561404,0.0611439842209073,0.02456140350877193
DJI_0265.JPG,99.jpg,ong_noi,3716,1284,3925,1340,0,209,56,3820,1312,0.9418145956607495,0.5754385964912281,0.05152859960552268,0.02456140350877193
DJI_0266.JPG,100.jpg,ong_noi,1928,1385,2477,1478,0,549,93,2202,1431,0.5428994082840237,0.6276315789473684,0.13535502958579881,0.04078947368421053
DJI_0266.JPG,100.jpg,ong_noi,1132,1577,1353,1618,0,221,41,1242,1597,0.3062130177514793,0.7004385964912281,0.05448717948717949,0.017982456140350878
DJI_0267.JPG,101.jpg,ong_noi,2099,1130,2610,1235,0,511,105,2354,1182,0.5803747534516766,0.5184210526315789,0.1259861932938856,0.046052631578947366
DJI_0267.JPG,101.jpg,ong_noi,1287,1445,1499,1502,0,212,57,1393,1473,0.34344181459566075,0.6460526315789473,0.05226824457593689,0.025
DJI_0268.JPG,102.jpg,ong_noi,2052,1151,2565,1288,0,513,137,2308,1219,0.5690335305719921,0.5346491228070176,0.1264792899408284,0.060087719298245613
DJI_0268.JPG,102.jpg,ong_noi,1464,1373,1658,1428,0,194,55,1561,1400,0.384861932938856,0.6140350877192983,0.04783037475345168,0.02412280701754386
DJI_0269.JPG,103.jpg,ong_noi,2068,1173,2622,1325,0,554,152,2345,1249,0.578155818540434,0.5478070175438596,0.13658777120315582,0.06666666666666667
DJI_0269.JPG,103.jpg,ong_noi,1540,1364,1731,1409,0,191,45,1635,1386,0.4031065088757396,0.6078947368421053,0.04709072978303747,0.019736842105263157
DJI_0270.JPG,104.jpg,ong_noi,2030,1238,2583,1420,0,553,182,2306,1329,0.5685404339250493,0.5828947368421052,0.13634122287968442,0.07982456140350877
DJI_0270.JPG,104.jpg,ong_noi,1725,1323,1917,1395,0,192,72,1821,1359,0.4489644970414201,0.5960526315789474,0.047337278106508875,0.031578947368421054
DJI_0271.JPG,105.jpg,ong_noi,1848,1263,2400,1526,0,552,263,2124,1394,0.5236686390532544,0.6114035087719298,0.13609467455621302,0.11535087719298245
DJI_0271.JPG,105.jpg,ong_noi,1863,1318,1991,1396,0,128,78,1927,1357,0.47509861932938857,0.5951754385964912,0.03155818540433925,0.034210526315789476
DJI_0272.JPG,106.jpg,ong_noi,1865,1230,2435,1489,0,570,259,2150,1359,0.5300788954635108,0.5960526315789474,0.14053254437869822,0.11359649122807018
DJI_0272.JPG,106.jpg,ong_noi,1879,1311,2037,1390,0,158,79,1958,1350,0.482741617357002,0.5921052631578947,0.03895463510848126,0.03464912280701754
DJI_0273.JPG,107.jpg,ong_noi,2082,1080,2664,1379,0,582,299,2373,1229,0.5850591715976331,0.5390350877192982,0.14349112426035504,0.13114035087719297
DJI_0273.JPG,107.jpg,ong_noi,2046,1260,2225,1359,0,179,99,2135,1309,0.5263806706114399,0.5741228070175438,0.044132149901380674,0.04342105263157895
DJI_0274.JPG,108.jpg,ong_noi,1662,1077,2219,1424,0,557,347,1940,1250,0.47830374753451677,0.5482456140350878,0.13732741617357003,0.15219298245614035
DJI_0274.JPG,108.jpg,ong_noi,1803,1276,1996,1363,0,193,87,1899,1319,0.4681952662721893,0.5785087719298245,0.047583826429980276,0.038157894736842106
DJI_0275.JPG,109.jpg,ong_noi,1586,1158,2204,1388,0,618,230,1895,1273,0.4672090729783038,0.5583333333333333,0.15236686390532544,0.10087719298245613
DJI_0275.JPG,109.jpg,ong_noi,1521,1328,1748,1399,0,227,71,1634,1363,0.40285996055226825,0.5978070175438597,0.05596646942800789,0.031140350877192982
DJI_0276.JPG,110.jpg,ong_noi,1552,1228,2184,1355,0,632,127,1868,1291,0.46055226824457596,0.5662280701754386,0.15581854043392504,0.05570175438596491
DJI_0276.JPG,110.jpg,ong_noi,1327,1404,1535,1457,0,208,53,1431,1430,0.35281065088757396,0.6271929824561403,0.05128205128205128,0.02324561403508772
DJI_0277.JPG,111.jpg,ong_noi,1778,1093,2324,1244,0,546,151,2051,1168,0.5056706114398422,0.512280701754386,0.1346153846153846,0.0662280701754386
DJI_0277.JPG,111.jpg,ong_noi,921,1611,1126,1675,0,205,64,1023,1643,0.2522189349112426,0.7206140350877193,0.05054240631163708,0.028070175438596492
DJI_0277.JPG,111.jpg,ong_noi,3666,1173,3830,1243,0,164,70,3748,1208,0.9240631163708086,0.5298245614035088,0.04043392504930966,0.03070175438596491
DJI_0278.JPG,112.jpg,ong_noi,1431,1075,1963,1431,0,532,356,1697,1253,0.41839250493096647,0.5495614035087719,0.131163708086785,0.156140350877193
DJI_0278.JPG,112.jpg,ong_noi,346,2060,554,2173,0,208,113,450,2116,0.11094674556213018,0.9280701754385965,0.05128205128205128,0.04956140350877193
DJI_0278.JPG,112.jpg,ong_noi,3431,1660,3569,1772,0,138,112,3500,1716,0.8629191321499013,0.7526315789473684,0.034023668639053255,0.04912280701754386
DJI_0279.JPG,113.jpg,ong_noi,1695,935,2091,1277,0,396,342,1893,1106,0.46671597633136097,0.4850877192982456,0.09763313609467456,0.15
DJI_0279.JPG,113.jpg,ong_noi,2369,633,2469,719,0,100,86,2419,676,0.5964003944773175,0.2964912280701754,0.02465483234714004,0.037719298245614034
DJI_0279.JPG,113.jpg,ong_noi,3098,1283,3220,1469,0,122,186,3159,1376,0.7788461538461539,0.6035087719298246,0.03007889546351085,0.08157894736842106
DJI_0281.JPG,114.jpg,ong_noi,1416,905,1982,1374,0,566,469,1699,1139,0.4188856015779093,0.49956140350877193,0.13954635108481261,0.2057017543859649
DJI_0281.JPG,114.jpg,ong_noi,2407,610,2531,709,0,124,99,2469,659,0.6087278106508875,0.28903508771929826,0.03057199211045365,0.04342105263157895
DJI_0281.JPG,114.jpg,ong_noi,3204,1373,3310,1482,0,106,109,3257,1427,0.803007889546351,0.6258771929824561,0.026134122287968443,0.04780701754385965
DJI_0281.JPG,114.jpg,ong_noi,3797,631,3900,796,0,103,165,3848,713,0.9487179487179487,0.312719298245614,0.025394477317554242,0.07236842105263158
DJI_0282.JPG,115.jpg,ong_noi,1491,922,2139,1407,0,648,485,1815,1164,0.4474852071005917,0.5105263157894737,0.15976331360946747,0.21271929824561403
DJI_0282.JPG,115.jpg,ong_noi,2623,652,2761,755,0,138,103,2692,703,0.6637080867850098,0.30833333333333335,0.034023668639053255,0.04517543859649123
DJI_0282.JPG,115.jpg,ong_noi,3376,1477,3501,1619,0,125,142,3438,1548,0.8476331360946746,0.6789473684210526,0.03081854043392505,0.062280701754385964
DJI_0283.JPG,116.jpg,ong_noi,1524,988,2138,1418,0,614,430,1831,1203,0.4514299802761341,0.5276315789473685,0.15138067061143984,0.18859649122807018
DJI_0283.JPG,116.jpg,ong_noi,3638,1716,3784,1851,0,146,135,3711,1783,0.9149408284023669,0.7820175438596492,0.03599605522682446,0.05921052631578947
DJI_0283.JPG,116.jpg,ong_noi,2951,747,3101,839,0,150,92,3026,793,0.7460552268244576,0.3478070175438597,0.03698224852071006,0.04035087719298246
DJI_0284.JPG,117.jpg,ong_noi,1592,1079,2264,1424,0,672,345,1928,1251,0.47534516765285995,0.5486842105263158,0.16568047337278108,0.1513157894736842
DJI_0284.JPG,117.jpg,ong_noi,3850,1928,3992,2056,0,142,128,3921,1992,0.966715976331361,0.8736842105263158,0.035009861932938854,0.056140350877192984
DJI_0284.JPG,117.jpg,ong_noi,3229,859,3384,954,0,155,95,3306,906,0.8150887573964497,0.3973684210526316,0.03821499013806706,0.041666666666666664
DJI_0284.JPG,117.jpg,ong_noi,409,1941,661,2056,0,252,115,535,1998,0.13190335305719922,0.8763157894736842,0.0621301775147929,0.05043859649122807
DJI_0285.JPG,118.jpg,ong_noi,1799,1089,2495,1327,0,696,238,2147,1208,0.5293392504930966,0.5298245614035088,0.17159763313609466,0.10438596491228071
DJI_0285.JPG,118.jpg,ong_noi,702,1718,949,1812,0,247,94,825,1765,0.20340236686390534,0.7741228070175439,0.060897435897435896,0.0412280701754386
DJI_0285.JPG,118.jpg,ong_noi,3648,1084,3830,1138,0,182,54,3739,1111,0.921844181459566,0.487280701754386,0.04487179487179487,0.02368421052631579
DJI_0285.JPG,118.jpg,ong_noi,3603,85,3812,155,0,209,70,3707,120,0.9139546351084813,0.05263157894736842,0.05152859960552268,0.03070175438596491
DJI_0286.JPG,119.jpg,ong_noi,2104,1209,2888,1352,0,784,143,2496,1280,0.6153846153846154,0.5614035087719298,0.1932938856015779,0.06271929824561404
DJI_0286.JPG,119.jpg,ong_noi,1088,1536,1303,1604,0,215,68,1195,1570,0.29462524654832345,0.6885964912280702,0.053007889546351085,0.02982456140350877
DJI_0287.JPG,120.jpg,ong_noi,1885,1326,2712,1494,0,827,168,2298,1410,0.5665680473372781,0.618421052631579,0.2038954635108481,0.07368421052631578
DJI_0287.JPG,120.jpg,ong_noi,1134,1514,1368,1579,0,234,65,1251,1546,0.3084319526627219,0.6780701754385965,0.057692307692307696,0.02850877192982456
DJI_0288.JPG,121.jpg,ong_noi,1839,1408,2627,1581,0,788,173,2233,1494,0.5505424063116371,0.6552631578947369,0.1942800788954635,0.07587719298245614
DJI_0288.JPG,121.jpg,ong_noi,1320,1454,1561,1510,0,241,56,1440,1482,0.35502958579881655,0.65,0.05941814595660749,0.02456140350877193
DJI_0289.JPG,122.jpg,ong_noi,1895,1177,2701,1377,0,806,200,2298,1277,0.5665680473372781,0.5600877192982456,0.1987179487179487,0.08771929824561403
DJI_0289.JPG,122.jpg,ong_noi,1355,1177,1562,1235,0,207,58,1458,1206,0.3594674556213018,0.5289473684210526,0.05103550295857988,0.02543859649122807
DJI_0290.JPG,123.jpg,ong_noi,1973,1171,2750,1424,0,777,253,2361,1297,0.5821005917159763,0.5688596491228071,0.1915680473372781,0.11096491228070175
DJI_0291.JPG,124.jpg,ong_noi,1499,1081,2240,1434,0,741,353,1869,1257,0.46079881656804733,0.5513157894736842,0.18269230769230768,0.15482456140350878
DJI_0291.JPG,124.jpg,ong_noi,1728,1037,1927,1133,0,199,96,1827,1085,0.4504437869822485,0.4758771929824561,0.04906311637080868,0.042105263157894736
DJI_0292.JPG,125.jpg,ong_noi,1609,1015,2314,1447,0,705,432,1961,1231,0.4834812623274162,0.5399122807017543,0.17381656804733728,0.18947368421052632
DJI_0292.JPG,125.jpg,ong_noi,1966,1038,2123,1127,0,157,89,2044,1082,0.5039447731755424,0.4745614035087719,0.038708086785009865,0.03903508771929825
DJI_0293.JPG,126.jpg,ong_noi,1736,968,2420,1508,0,684,540,2078,1238,0.51232741617357,0.5429824561403509,0.16863905325443787,0.23684210526315788
DJI_0293.JPG,126.jpg,ong_noi,2221,1039,2352,1149,0,131,110,2286,1094,0.5636094674556213,0.47982456140350876,0.03229783037475345,0.04824561403508772
DJI_0294.JPG,127.jpg,ong_noi,1900,955,2504,1496,0,604,541,2202,1225,0.5428994082840237,0.5372807017543859,0.14891518737672585,0.23728070175438595
DJI_0294.JPG,127.jpg,ong_noi,2330,1033,2519,1189,0,189,156,2424,1111,0.5976331360946746,0.487280701754386,0.04659763313609468,0.06842105263157895
DJI_0295.JPG,128.jpg,ong_noi,1951,889,2546,1478,0,595,589,2248,1183,0.5542406311637081,0.518859649122807,0.14669625246548323,0.25833333333333336
DJI_0295.JPG,128.jpg,ong_noi,2447,1060,2592,1197,0,145,137,2519,1128,0.6210552268244576,0.49473684210526314,0.03574950690335306,0.060087719298245613
DJI_0296.JPG,129.jpg,ong_noi,1962,870,2528,1472,0,566,602,2245,1171,0.5535009861932939,0.5135964912280702,0.13954635108481261,0.26403508771929823
DJI_0296.JPG,129.jpg,ong_noi,2531,1091,2667,1216,0,136,125,2599,1153,0.6407790927021696,0.5057017543859649,0.03353057199211045,0.05482456140350877
DJI_0297.JPG,130.jpg,ong_noi,1926,938,2443,1641,0,517,703,2184,1289,0.5384615384615384,0.5653508771929825,0.12746548323471402,0.30833333333333335
DJI_0297.JPG,130.jpg,ong_noi,2666,1150,2787,1293,0,121,143,2726,1221,0.6720907297830375,0.5355263157894737,0.029832347140039447,0.06271929824561404
DJI_0298.JPG,131.jpg,ong_noi,2206,1124,2620,1854,0,414,730,2413,1489,0.5949211045364892,0.6530701754385965,0.10207100591715976,0.3201754385964912
DJI_0298.JPG,131.jpg,ong_noi,2902,1270,3013,1431,0,111,161,2957,1350,0.729043392504931,0.5921052631578947,0.027366863905325445,0.0706140350877193
DJI_0299.JPG,132.jpg,ong_noi,2272,634,2752,1220,0,480,586,2512,927,0.6193293885601578,0.40657894736842104,0.11834319526627218,0.25701754385964914
DJI_0299.JPG,132.jpg,ong_noi,2910,1152,3031,1321,0,121,169,2970,1236,0.7322485207100592,0.5421052631578948,0.029832347140039447,0.07412280701754385
DJI_0300.JPG,133.jpg,ong_noi,2085,703,2397,1333,0,312,630,2241,1018,0.5525147928994083,0.44649122807017544,0.07692307692307693,0.27631578947368424
DJI_0300.JPG,133.jpg,ong_noi,2947,1213,3077,1413,0,130,200,3012,1313,0.742603550295858,0.5758771929824561,0.03205128205128205,0.08771929824561403
DJI_0302.JPG,134.jpg,ong_noi,2309,870,2508,1601,0,199,731,2408,1235,0.5936883629191322,0.5416666666666666,0.04906311637080868,0.3206140350877193
DJI_0302.JPG,134.jpg,ong_noi,3269,1451,3346,1628,0,77,177,3307,1539,0.8153353057199211,0.675,0.01898422090729783,0.07763157894736843
DJI_0303.JPG,135.jpg,ong_noi,2451,995,2610,1685,0,159,690,2530,1340,0.623767258382643,0.5877192982456141,0.03920118343195266,0.3026315789473684
DJI_0303.JPG,135.jpg,ong_noi,3490,1649,3571,1876,0,81,227,3530,1762,0.8703155818540433,0.7728070175438596,0.019970414201183433,0.09956140350877193
DJI_0304.JPG,136.jpg,ong_noi,2530,1115,2709,1824,0,179,709,2619,1469,0.6457100591715976,0.644298245614035,0.044132149901380674,0.3109649122807018
DJI_0304.JPG,136.jpg,ong_noi,3549,1708,3649,1941,0,100,233,3599,1824,0.88732741617357,0.8,0.02465483234714004,0.10219298245614035
DJI_0305.JPG,137.jpg,ong_noi,2470,863,2633,1414,0,163,551,2551,1138,0.6289447731755424,0.49912280701754386,0.04018737672583826,0.24166666666666667
DJI_0305.JPG,137.jpg,ong_noi,3548,1650,3628,1885,0,80,235,3588,1767,0.8846153846153846,0.775,0.01972386587771203,0.10307017543859649
DJI_0306.JPG,138.jpg,ong_noi,2503,898,2659,1478,0,156,580,2581,1188,0.6363412228796844,0.5210526315789473,0.038461538461538464,0.2543859649122807
DJI_0306.JPG,138.jpg,ong_noi,3632,1742,3723,1982,0,91,240,3677,1862,0.9065581854043393,0.8166666666666667,0.022435897435897436,0.10526315789473684
DJI_0307.JPG,139.jpg,ong_noi,2468,930,2626,1490,0,158,560,2547,1210,0.6279585798816568,0.5307017543859649,0.03895463510848126,0.24561403508771928
DJI_0307.JPG,139.jpg,ong_noi,3713,1880,3793,2071,0,80,191,3753,1975,0.9252958579881657,0.8662280701754386,0.01972386587771203,0.0837719298245614
DJI_0308.JPG,140.jpg,ong_noi,2423,872,2686,1610,0,263,738,2554,1241,0.6296844181459567,0.5442982456140351,0.0648422090729783,0.3236842105263158
DJI_0308.JPG,140.jpg,ong_noi,3757,1951,3827,2152,0,70,201,3792,2051,0.9349112426035503,0.8995614035087719,0.01725838264299803,0.0881578947368421
DJI_0309.JPG,141.jpg,ong_noi,2527,1000,2742,1646,0,215,646,2634,1323,0.6494082840236687,0.5802631578947368,0.053007889546351085,0.2833333333333333
DJI_0310.JPG,142.jpg,ong_noi,2208,1054,2513,1636,0,305,582,2360,1345,0.5818540433925049,0.5899122807017544,0.07519723865877712,0.25526315789473686
DJI_0311.JPG,143.jpg,ong_noi,2052,1086,2406,1709,0,354,623,2229,1397,0.5495562130177515,0.612719298245614,0.08727810650887574,0.27324561403508774
DJI_0312.JPG,144.jpg,ong_noi,2041,1072,2422,1724,0,381,652,2231,1398,0.5500493096646942,0.6131578947368421,0.09393491124260354,0.28596491228070176
DJI_0313.JPG,145.jpg,ong_noi,2153,1103,2565,1691,0,412,588,2359,1397,0.5816074950690335,0.612719298245614,0.10157790927021697,0.2578947368421053
DJI_0314.JPG,146.jpg,ong_noi,2101,1076,2610,1639,0,509,563,2355,1357,0.5806213017751479,0.5951754385964912,0.1254930966469428,0.2469298245614035
DJI_0315.JPG,147.jpg,ong_noi,1846,1086,2369,1636,0,523,550,2107,1361,0.5194773175542406,0.5969298245614035,0.1289447731755424,0.2412280701754386
DJI_0316.JPG,148.jpg,ong_noi,1723,1132,2315,1705,0,592,573,2019,1418,0.4977810650887574,0.6219298245614036,0.14595660749506903,0.2513157894736842
DJI_0317.JPG,149.jpg,ong_noi,1707,1198,2369,1683,0,662,485,2038,1440,0.502465483234714,0.631578947368421,0.16321499013806706,0.21271929824561403
DJI_0318.JPG,150.jpg,ong_noi,1822,1215,2461,1604,0,639,389,2141,1409,0.5278599605522682,0.6179824561403509,0.15754437869822485,0.1706140350877193
DJI_0320.JPG,151.jpg,ong_noi,1834,1319,2615,1645,0,781,326,2224,1482,0.5483234714003945,0.65,0.19255424063116372,0.14298245614035088
DJI_0321.JPG,152.jpg,ong_noi,1702,1356,2632,1722,0,930,366,2167,1539,0.5342702169625246,0.675,0.22928994082840237,0.16052631578947368
DJI_0322.JPG,153.jpg,ong_noi,1674,1480,2598,1718,0,924,238,2136,1599,0.5266272189349113,0.7013157894736842,0.22781065088757396,0.10438596491228071
DJI_0323.JPG,154.jpg,ong_noi,1801,1597,2654,1753,0,853,156,2227,1675,0.5490631163708086,0.7346491228070176,0.21030571992110453,0.06842105263157895
DJI_0324.JPG,155.jpg,ong_noi,1890,1164,2780,1343,0,890,179,2335,1253,0.5756903353057199,0.5495614035087719,0.21942800788954636,0.07850877192982456
DJI_0325.JPG,156.jpg,ong_noi,1902,1112,2978,1351,0,1076,239,2440,1231,0.6015779092702169,0.5399122807017543,0.26528599605522685,0.10482456140350878
DJI_0326.JPG,157.jpg,ong_noi,1611,1064,2544,1377,0,933,313,2077,1220,0.5120808678500987,0.5350877192982456,0.23002958579881658,0.13728070175438598
DJI_0327.JPG,158.jpg,ong_noi,1473,1027,2444,1393,0,971,366,1958,1210,0.482741617357002,0.5307017543859649,0.23939842209072978,0.16052631578947368
DJI_0327.JPG,158.jpg,ong_noi,1,1492,149,1574,0,148,82,75,1533,0.01849112426035503,0.6723684210526316,0.03648915187376726,0.035964912280701755
DJI_0328.JPG,159.jpg,ong_noi,1735,976,2583,1411,0,848,435,2159,1193,0.5322978303747534,0.5232456140350877,0.20907297830374755,0.19078947368421054
DJI_0328.JPG,159.jpg,ong_noi,285,1071,463,1175,0,178,104,374,1123,0.09220907297830375,0.4925438596491228,0.04388560157790927,0.0456140350877193
DJI_0329.JPG,160.jpg,ong_noi,1815,902,2507,1260,0,692,358,2161,1081,0.5327909270216963,0.47412280701754383,0.17061143984220908,0.1570175438596491
DJI_0329.JPG,160.jpg,ong_noi,368,1150,556,1259,0,188,109,462,1204,0.11390532544378698,0.5280701754385965,0.046351084812623275,0.04780701754385965
DJI_0330.JPG,161.jpg,ong_noi,1917,930,2522,1250,0,605,320,2219,1090,0.5470907297830375,0.4780701754385965,0.14916173570019725,0.14035087719298245
DJI_0330.JPG,161.jpg,ong_noi,484,1094,633,1192,0,149,98,558,1143,0.13757396449704143,0.5013157894736842,0.03673570019723866,0.04298245614035088
DJI_0331.JPG,162.jpg,ong_noi,2035,947,2694,1310,0,659,363,2364,1128,0.5828402366863905,0.49473684210526314,0.16247534516765286,0.15921052631578947
DJI_0331.JPG,162.jpg,ong_noi,535,1031,701,1156,0,166,125,618,1093,0.15236686390532544,0.4793859649122807,0.040927021696252466,0.05482456140350877
DJI_0332.JPG,163.jpg,ong_noi,1788,891,2374,1346,0,586,455,2081,1118,0.5130670611439843,0.4903508771929825,0.14447731755424062,0.19956140350877194
DJI_0332.JPG,163.jpg,ong_noi,703,895,818,998,0,115,103,760,946,0.1873767258382643,0.4149122807017544,0.028353057199211044,0.04517543859649123
DJI_0333.JPG,164.jpg,ong_noi,1977,943,2445,1401,0,468,458,2211,1172,0.5451183431952663,0.5140350877192983,0.11538461538461539,0.20087719298245615
DJI_0333.JPG,164.jpg,ong_noi,938,772,1050,901,0,112,129,994,836,0.245069033530572,0.36666666666666664,0.027613412228796843,0.056578947368421055
DJI_0334.JPG,165.jpg,ong_noi,2012,922,2469,1461,0,457,539,2240,1191,0.5522682445759369,0.5223684210526316,0.11267258382642999,0.23640350877192984
DJI_0334.JPG,165.jpg,ong_noi,1109,684,1201,813,0,92,129,1155,748,0.28476331360946744,0.3280701754385965,0.022682445759368838,0.056578947368421055
DJI_0335.JPG,166.jpg,ong_noi,1855,964,2224,1511,0,369,547,2039,1237,0.5027120315581854,0.5425438596491228,0.09097633136094675,0.23991228070175438
DJI_0335.JPG,166.jpg,ong_noi,1202,631,1288,775,0,86,144,1245,703,0.3069526627218935,0.30833333333333335,0.021203155818540435,0.06315789473684211
DJI_0336.JPG,167.jpg,ong_noi,1952,984,2296,1641,0,344,657,2124,1312,0.5236686390532544,0.5754385964912281,0.08481262327416174,0.2881578947368421
DJI_0336.JPG,167.jpg,ong_noi,1412,583,1480,725,0,68,142,1446,654,0.35650887573964496,0.2868421052631579,0.016765285996055226,0.062280701754385964
DJI_0336.JPG,167.jpg,ong_noi,152,673,215,828,0,63,155,183,750,0.045118343195266274,0.32894736842105265,0.015532544378698224,0.06798245614035088
DJI_0337.JPG,168.jpg,ong_noi,2083,1050,2360,1713,0,277,663,2221,1381,0.5475838264299803,0.605701754385965,0.06829388560157791,0.29078947368421054
DJI_0337.JPG,168.jpg,ong_noi,1602,539,1663,708,0,61,169,1632,623,0.40236686390532544,0.27324561403508774,0.015039447731755425,0.07412280701754385
DJI_0337.JPG,168.jpg,ong_noi,380,537,431,699,0,51,162,405,618,0.09985207100591716,0.2710526315789474,0.01257396449704142,0.07105263157894737
DJI_0338.JPG,169.jpg,ong_noi,2172,1133,2406,1843,0,234,710,2289,1488,0.5643491124260355,0.6526315789473685,0.057692307692307696,0.31140350877192985
DJI_0338.JPG,169.jpg,ong_noi,604,441,657,563,0,53,122,630,502,0.15532544378698224,0.22017543859649122,0.013067061143984222,0.05350877192982456
DJI_0338.JPG,169.jpg,ong_noi,1793,530,1846,687,0,53,157,1819,608,0.4484714003944773,0.26666666666666666,0.013067061143984222,0.06885964912280702
DJI_0339.JPG,170.jpg,ong_noi,2224,1178,2401,1933,0,177,755,2312,1555,0.5700197238658777,0.6820175438596491,0.04363905325443787,0.33114035087719296
DJI_0339.JPG,170.jpg,ong_noi,869,320,908,448,0,39,128,888,384,0.21893491124260356,0.16842105263157894,0.009615384615384616,0.056140350877192984
DJI_0339.JPG,170.jpg,ong_noi,2013,531,2062,681,0,49,150,2037,606,0.5022189349112426,0.2657894736842105,0.012080867850098619,0.06578947368421052
DJI_0340.JPG,171.jpg,ong_noi,2170,1377,2298,2085,0,128,708,2234,1731,0.5507889546351085,0.7592105263157894,0.03155818540433925,0.3105263157894737
DJI_0340.JPG,171.jpg,ong_noi,1143,237,1198,357,0,55,120,1170,297,0.28846153846153844,0.13026315789473683,0.013560157790927022,0.05263157894736842
DJI_0341.JPG,172.jpg,ong_noi,2186,736,2441,1418,0,255,682,2313,1077,0.5702662721893491,0.4723684210526316,0.0628698224852071,0.29912280701754385
DJI_0341.JPG,172.jpg,ong_noi,1261,117,1311,248,0,50,131,1286,182,0.3170611439842209,0.07982456140350877,0.01232741617357002,0.05745614035087719
DJI_0342.JPG,173.jpg,ong_noi,2348,710,2665,1402,0,317,692,2506,1056,0.6178500986193294,0.4631578947368421,0.07815581854043392,0.30350877192982456
DJI_0342.JPG,173.jpg,ong_noi,1582,23,1647,173,0,65,150,1614,98,0.3979289940828402,0.04298245614035088,0.016025641025641024,0.06578947368421052
DJI_0343.JPG,174.jpg,ong_noi,2257,777,2565,1447,0,308,670,2411,1112,0.5944280078895463,0.48771929824561405,0.07593688362919132,0.29385964912280704
DJI_0343.JPG,174.jpg,ong_noi,1920,11,2015,146,0,95,135,1967,78,0.4849605522682446,0.034210526315789476,0.02342209072978304,0.05921052631578947
DJI_0344.JPG,175.jpg,ong_noi,2299,884,2667,1543,0,368,659,2483,1213,0.6121794871794872,0.5320175438596492,0.09072978303747535,0.28903508771929826
DJI_0344.JPG,175.jpg,ong_noi,2119,26,2201,149,0,82,123,2160,87,0.5325443786982249,0.038157894736842106,0.02021696252465483,0.05394736842105263
DJI_0345.JPG,176.jpg,ong_noi,2207,964,2748,1656,0,541,692,2477,1310,0.6107001972386588,0.5745614035087719,0.1333826429980276,0.30350877192982456
DJI_0345.JPG,176.jpg,ong_noi,2254,37,2350,164,0,96,127,2302,100,0.5675542406311637,0.043859649122807015,0.023668639053254437,0.05570175438596491
DJI_0346.JPG,177.jpg,ong_noi,2327,1014,2757,1639,0,430,625,2542,1326,0.6267258382642998,0.5815789473684211,0.10601577909270217,0.2741228070175439
DJI_0346.JPG,177.jpg,ong_noi,2389,78,2471,186,0,82,108,2430,132,0.599112426035503,0.05789473684210526,0.02021696252465483,0.04736842105263158
DJI_0347.JPG,178.jpg,ong_noi,2390,1136,2874,1690,0,484,554,2632,1413,0.6489151873767258,0.6197368421052631,0.11932938856015779,0.24298245614035088
DJI_0347.JPG,178.jpg,ong_noi,2622,117,2754,230,0,132,113,2688,173,0.6627218934911243,0.07587719298245614,0.03254437869822485,0.04956140350877193
DJI_0347.JPG,178.jpg,ong_noi,330,2021,519,2204,0,189,183,424,2112,0.10453648915187377,0.9263157894736842,0.04659763313609468,0.08026315789473684
DJI_0347.JPG,178.jpg,ong_noi,3427,950,3525,1084,0,98,134,3476,1017,0.8570019723865878,0.44605263157894737,0.024161735700197237,0.058771929824561406
DJI_0348.JPG,179.jpg,ong_noi,2622,1319,3235,1828,0,613,509,2928,1573,0.7218934911242604,0.6899122807017544,0.15113412228796844,0.22324561403508772
DJI_0348.JPG,179.jpg,ong_noi,3051,231,3196,330,0,145,99,3123,280,0.7699704142011834,0.12280701754385964,0.03574950690335306,0.04342105263157895
DJI_0348.JPG,179.jpg,ong_noi,3753,1216,3871,1332,0,118,116,3812,1274,0.9398422090729783,0.5587719298245614,0.029092702169625246,0.05087719298245614
DJI_0348.JPG,179.jpg,ong_noi,521,1776,699,1931,0,178,155,610,1853,0.15039447731755423,0.8127192982456141,0.04388560157790927,0.06798245614035088
DJI_0349.JPG,180.jpg,ong_noi,2021,1166,2678,1663,0,657,497,2349,1414,0.5791420118343196,0.6201754385964913,0.16198224852071005,0.2179824561403509
DJI_0349.JPG,180.jpg,ong_noi,2954,205,3108,314,0,154,109,3031,259,0.7472879684418146,0.11359649122807018,0.03796844181459566,0.04780701754385965
DJI_0349.JPG,180.jpg,ong_noi,3635,1188,3768,1294,0,133,106,3701,1241,0.9124753451676528,0.5442982456140351,0.03279092702169625,0.04649122807017544
DJI_0349.JPG,180.jpg,ong_noi,394,1755,595,1892,0,201,137,494,1823,0.12179487179487179,0.7995614035087719,0.04955621301775148,0.060087719298245613
DJI_0350.JPG,181.jpg,ong_noi,2147,1202,2789,1654,0,642,452,2468,1428,0.6084812623274162,0.6263157894736842,0.15828402366863906,0.19824561403508772
DJI_0350.JPG,181.jpg,ong_noi,3078,259,3207,337,0,129,78,3142,298,0.77465483234714,0.1307017543859649,0.031804733727810654,0.034210526315789476
DJI_0350.JPG,181.jpg,ong_noi,3720,1243,3872,1364,0,152,121,3796,1303,0.9358974358974359,0.5714912280701754,0.03747534516765286,0.05307017543859649
DJI_0350.JPG,181.jpg,ong_noi,455,1691,666,1829,0,211,138,560,1760,0.13806706114398423,0.7719298245614035,0.052021696252465485,0.060526315789473685
DJI_0351.JPG,182.jpg,ong_noi,2041,1280,2726,1715,0,685,435,2383,1497,0.5875246548323472,0.656578947368421,0.16888560157790927,0.19078947368421054
DJI_0351.JPG,182.jpg,ong_noi,3140,288,3282,372,0,142,84,3211,330,0.7916666666666666,0.14473684210526316,0.035009861932938854,0.03684210526315789
DJI_0351.JPG,182.jpg,ong_noi,3753,1324,3903,1437,0,150,113,3828,1380,0.9437869822485208,0.6052631578947368,0.03698224852071006,0.04956140350877193
DJI_0351.JPG,182.jpg,ong_noi,474,1653,691,1787,0,217,134,582,1720,0.14349112426035504,0.7543859649122807,0.05350098619329389,0.058771929824561406
DJI_0352.JPG,183.jpg,ong_noi,2118,1322,2836,1755,0,718,433,2477,1538,0.6107001972386588,0.6745614035087719,0.17702169625246547,0.1899122807017544
DJI_0352.JPG,183.jpg,ong_noi,3231,327,3389,412,0,158,85,3310,369,0.8160749506903353,0.1618421052631579,0.03895463510848126,0.03728070175438596
DJI_0352.JPG,183.jpg,ong_noi,3833,1397,3963,1494,0,130,97,3898,1445,0.9610453648915187,0.6337719298245614,0.03205128205128205,0.04254385964912281
DJI_0352.JPG,183.jpg,ong_noi,539,1602,768,1732,0,229,130,653,1667,0.16099605522682445,0.731140350877193,0.05645956607495069,0.05701754385964912
DJI_0353.JPG,184.jpg,ong_noi,1506,1324,2280,1757,0,774,433,1893,1540,0.46671597633136097,0.6754385964912281,0.1908284023668639,0.1899122807017544
DJI_0353.JPG,184.jpg,ong_noi,3179,351,3329,433,0,150,82,3254,392,0.8022682445759369,0.17192982456140352,0.03698224852071006,0.035964912280701755
DJI_0353.JPG,184.jpg,ong_noi,3767,1438,3899,1532,0,132,94,3833,1485,0.9450197238658777,0.6513157894736842,0.03254437869822485,0.0412280701754386
DJI_0353.JPG,184.jpg,ong_noi,410,1581,641,1705,0,231,124,525,1643,0.1294378698224852,0.7206140350877193,0.05695266272189349,0.054385964912280704
DJI_0354.JPG,185.jpg,ong_noi,1635,1405,2453,1746,0,818,341,2044,1575,0.5039447731755424,0.6907894736842105,0.20167652859960553,0.14956140350877192
DJI_0354.JPG,185.jpg,ong_noi,3462,493,3641,561,0,179,68,3551,527,0.8754930966469427,0.23114035087719298,0.044132149901380674,0.02982456140350877
DJI_0354.JPG,185.jpg,ong_noi,584,1440,801,1528,0,217,88,692,1484,0.17061143984220908,0.6508771929824562,0.05350098619329389,0.03859649122807018
DJI_0355.JPG,186.jpg,ong_noi,1630,1536,2511,1750,0,881,214,2070,1643,0.5103550295857988,0.7206140350877193,0.21720907297830375,0.09385964912280702
DJI_0355.JPG,186.jpg,ong_noi,3831,773,4018,822,0,187,49,3924,797,0.9674556213017751,0.3495614035087719,0.04610453648915187,0.02149122807017544
DJI_0355.JPG,186.jpg,ong_noi,803,1266,1070,1332,0,267,66,936,1299,0.23076923076923078,0.5697368421052632,0.06582840236686391,0.02894736842105263
DJI_0356.JPG,187.jpg,ong_noi,1644,1565,2540,1827,0,896,262,2092,1696,0.5157790927021696,0.743859649122807,0.22090729783037474,0.11491228070175438
DJI_0356.JPG,187.jpg,ong_noi,973,1139,1223,1235,0,250,96,1098,1187,0.27071005917159763,0.5206140350877193,0.0616370808678501,0.042105263157894736
DJI_0357.JPG,188.jpg,ong_noi,1640,56,2657,335,0,1017,279,2148,195,0.5295857988165681,0.08552631578947369,0.2507396449704142,0.12236842105263158
DJI_0358.JPG,189.jpg,ong_noi,1772,754,2624,935,0,852,181,2198,844,0.5419132149901381,0.3701754385964912,0.21005917159763313,0.0793859649122807
DJI_0358.JPG,189.jpg,ong_noi,961,267,1186,328,0,225,61,1073,297,0.2645463510848126,0.13026315789473683,0.05547337278106509,0.02675438596491228
DJI_0359.JPG,190.jpg,ong_noi,1791,813,2590,967,0,799,154,2190,890,0.5399408284023669,0.39035087719298245,0.19699211045364892,0.06754385964912281
DJI_0359.JPG,190.jpg,ong_noi,1065,208,1285,268,0,220,60,1175,238,0.28969428007889547,0.10438596491228071,0.054240631163708086,0.02631578947368421
DJI_0360.JPG,191.jpg,ong_noi,1852,872,2808,1136,0,956,264,2330,1004,0.5744575936883629,0.44035087719298244,0.2357001972386588,0.11578947368421053
DJI_0360.JPG,191.jpg,ong_noi,1386,87,1618,155,0,232,68,1502,121,0.3703155818540434,0.05307017543859649,0.05719921104536489,0.02982456140350877
DJI_0361.JPG,192.jpg,ong_noi,1611,847,2498,1239,0,887,392,2054,1043,0.5064102564102564,0.45745614035087717,0.21868836291913216,0.17192982456140352
DJI_0361.JPG,192.jpg,ong_noi,1469,49,1700,143,0,231,94,1584,96,0.3905325443786982,0.042105263157894736,0.05695266272189349,0.0412280701754386
DJI_0363.JPG,193.jpg,khoa_neo,976,1084,1086,1146,1,110,62,1031,1115,0.2541913214990138,0.48903508771929827,0.027120315581854043,0.027192982456140352
DJI_0363.JPG,193.jpg,khoa_neo,821,126,1039,231,1,218,105,930,178,0.22928994082840237,0.0780701754385965,0.05374753451676528,0.046052631578947366
DJI_0363.JPG,193.jpg,khoa_neo,1166,1980,1266,2052,1,100,72,1216,2016,0.29980276134122286,0.8842105263157894,0.02465483234714004,0.031578947368421054
DJI_0363.JPG,193.jpg,khoa_neo,517,547,943,742,1,426,195,730,644,0.1799802761341223,0.2824561403508772,0.10502958579881656,0.08552631578947369
DJI_0363.JPG,193.jpg,khoa_neo,45,647,516,848,1,471,201,280,747,0.06903353057199212,0.32763157894736844,0.11612426035502958,0.0881578947368421
DJI_0363.JPG,193.jpg,tru_su,1258,109,1705,220,2,447,111,1481,164,0.365138067061144,0.07192982456140351,0.11020710059171597,0.04868421052631579
DJI_0363.JPG,193.jpg,tru_su,2043,143,2118,394,2,75,251,2080,268,0.5128205128205128,0.11754385964912281,0.01849112426035503,0.11008771929824561
DJI_0363.JPG,193.jpg,tru_su,1184,1031,1526,1129,2,342,98,1355,1080,0.33407297830374755,0.47368421052631576,0.08431952662721894,0.04298245614035088
DJI_0363.JPG,193.jpg,tru_su,2435,502,3209,733,2,774,231,2822,617,0.6957593688362919,0.2706140350877193,0.1908284023668639,0.1013157894736842
DJI_0363.JPG,193.jpg,tru_su,2025,803,2196,932,2,171,129,2110,867,0.5202169625246549,0.38026315789473686,0.04215976331360947,0.056578947368421055
DJI_0363.JPG,193.jpg,tru_su,3615,737,4027,1285,2,412,548,3821,1011,0.9420611439842209,0.44342105263157894,0.10157790927021697,0.24035087719298245
DJI_0363.JPG,193.jpg,tru_su,4001,1806,4056,1980,2,55,174,4028,1893,0.9930966469428008,0.8302631578947368,0.013560157790927022,0.07631578947368421
DJI_0363.JPG,193.jpg,tru_su,2232,1544,2375,1713,2,143,169,2303,1628,0.5678007889546351,0.7140350877192982,0.035256410256410256,0.07412280701754385
DJI_0363.JPG,193.jpg,tru_su,2082,1680,2123,1853,2,41,173,2102,1766,0.5182445759368837,0.7745614035087719,0.010108481262327416,0.07587719298245614
DJI_0363.JPG,193.jpg,tru_su,1416,1927,1742,2027,2,326,100,1579,1977,0.38929980276134124,0.8671052631578947,0.08037475345167652,0.043859649122807015
DJI_0363.JPG,193.jpg,khoa_neo,1132,1922,1253,1984,1,121,62,1192,1953,0.2938856015779093,0.8565789473684211,0.029832347140039447,0.027192982456140352
DJI_0363.JPG,193.jpg,khoa_neo,965,1038,1068,1094,1,103,56,1016,1066,0.2504930966469428,0.4675438596491228,0.025394477317554242,0.02456140350877193
DJI_0363.JPG,193.jpg,khoa_neo,907,176,1110,264,1,203,88,1008,220,0.2485207100591716,0.09649122807017543,0.05004930966469428,0.03859649122807018
DJI_0364.JPG,194.jpg,khoa_neo,390,1423,522,1506,1,132,83,456,1464,0.11242603550295859,0.6421052631578947,0.03254437869822485,0.03640350877192983
DJI_0364.JPG,194.jpg,khoa_neo,45,90,195,183,1,150,93,120,136,0.029585798816568046,0.05964912280701754,0.03698224852071006,0.04078947368421053
DJI_0364.JPG,194.jpg,khoa_neo,2395,1355,2870,1627,1,475,272,2632,1491,0.6489151873767258,0.6539473684210526,0.11711045364891519,0.11929824561403508
DJI_0364.JPG,194.jpg,khoa_neo,1879,1591,2509,1881,1,630,290,2194,1736,0.5409270216962525,0.7614035087719299,0.15532544378698224,0.12719298245614036
DJI_0364.JPG,194.jpg,tru_su,335,3,837,140,2,502,137,586,71,0.14447731755424062,0.031140350877192982,0.12376725838264299,0.060087719298245613
DJI_0364.JPG,194.jpg,tru_su,758,1318,1258,1486,2,500,168,1008,1402,0.2485207100591716,0.6149122807017544,0.1232741617357002,0.07368421052631578
DJI_0364.JPG,194.jpg,tru_su,1767,1080,1816,1196,2,49,116,1791,1138,0.4415680473372781,0.49912280701754386,0.012080867850098619,0.05087719298245614
DJI_0364.JPG,194.jpg,tru_su,1959,923,2095,1093,2,136,170,2027,1008,0.4997534516765286,0.4421052631578947,0.03353057199211045,0.07456140350877193
DJI_0364.JPG,194.jpg,khoa_neo,390,1373,522,1437,1,132,64,456,1405,0.11242603550295859,0.6162280701754386,0.03254437869822485,0.028070175438596492
DJI_0364.JPG,194.jpg,tru_su,3419,1250,4056,1769,2,637,519,3737,1509,0.9213510848126233,0.6618421052631579,0.15705128205128205,0.22763157894736843
DJI_0364.JPG,194.jpg,tru_su,3530,1783,3800,2013,2,270,230,3665,1898,0.9035996055226825,0.8324561403508772,0.06656804733727811,0.10087719298245613
DJI_0365.JPG,195.jpg,khoa_neo,348,1406,495,1478,1,147,72,421,1442,0.10379684418145957,0.6324561403508772,0.036242603550295856,0.031578947368421054
DJI_0365.JPG,195.jpg,khoa_neo,1,17,229,182,1,228,165,115,99,0.028353057199211044,0.04342105263157895,0.05621301775147929,0.07236842105263158
DJI_0365.JPG,195.jpg,khoa_neo,2434,1288,2879,1518,1,445,230,2656,1403,0.6548323471400395,0.6153508771929824,0.10971400394477318,0.10087719298245613
DJI_0365.JPG,195.jpg,khoa_neo,1879,1512,2594,1862,1,715,350,2236,1687,0.5512820512820513,0.7399122807017544,0.1762820512820513,0.15350877192982457
DJI_0365.JPG,195.jpg,tru_su,333,1,839,102,2,506,101,586,51,0.14447731755424062,0.02236842105263158,0.1247534516765286,0.04429824561403509
DJI_0365.JPG,195.jpg,tru_su,760,1292,1254,1460,2,494,168,1007,1376,0.2482741617357002,0.6035087719298246,0.12179487179487179,0.07368421052631578
DJI_0365.JPG,195.jpg,tru_su,1976,913,2108,1074,2,132,161,2042,993,0.5034516765285996,0.4355263157894737,0.03254437869822485,0.0706140350877193
DJI_0365.JPG,195.jpg,tru_su,3489,1194,4056,1696,2,567,502,3772,1445,0.9299802761341223,0.6337719298245614,0.13979289940828402,0.22017543859649122
DJI_0365.JPG,195.jpg,khoa_neo,367,1351,552,1424,1,185,73,459,1387,0.11316568047337278,0.6083333333333333,0.04561143984220907,0.032017543859649125
DJI_0365.JPG,195.jpg,tru_su,3496,1619,3824,1981,2,328,362,3660,1800,0.9023668639053254,0.7894736842105263,0.08086785009861933,0.1587719298245614
DJI_0366.JPG,196.jpg,khoa_neo,249,1346,442,1427,1,193,81,345,1386,0.08505917159763314,0.6078947368421053,0.047583826429980276,0.035526315789473684
DJI_0366.JPG,196.jpg,khoa_neo,2044,1296,2517,1520,1,473,224,2280,1408,0.5621301775147929,0.6175438596491228,0.11661735700197239,0.09824561403508772
DJI_0366.JPG,196.jpg,khoa_neo,1514,1560,2070,1809,1,556,249,1792,1684,0.4418145956607495,0.7385964912280701,0.13708086785009863,0.10921052631578948
DJI_0366.JPG,196.jpg,khoa_neo,1,42,102,162,1,101,120,51,102,0.01257396449704142,0.04473684210526316,0.02490138067061144,0.05263157894736842
DJI_0366.JPG,196.jpg,tru_su,215,1,714,90,2,499,89,464,45,0.11439842209072978,0.019736842105263157,0.1230276134122288,0.03903508771929825
DJI_0366.JPG,196.jpg,tru_su,643,1301,1155,1445,2,512,144,899,1373,0.22164694280078895,0.6021929824561404,0.126232741617357,0.06315789473684211
DJI_0366.JPG,196.jpg,tru_su,3124,1165,4056,1685,2,932,520,3590,1425,0.8851084812623274,0.625,0.22978303747534518,0.22807017543859648
DJI_0366.JPG,196.jpg,tru_su,3414,1630,3701,2001,2,287,371,3557,1815,0.8769723865877712,0.7960526315789473,0.07075936883629191,0.16271929824561404
DJI_0366.JPG,196.jpg,tru_su,1891,911,2050,1072,2,159,161,1970,991,0.48570019723865876,0.43464912280701756,0.03920118343195266,0.0706140350877193
DJI_0366.JPG,196.jpg,khoa_neo,246,1402,422,1464,1,176,62,334,1433,0.08234714003944774,0.6285087719298246,0.04339250493096647,0.027192982456140352
DJI_0367.JPG,197.jpg,khoa_neo,176,1351,320,1455,1,144,104,248,1403,0.0611439842209073,0.6153508771929824,0.03550295857988166,0.0456140350877193
DJI_0367.JPG,197.jpg,khoa_neo,2240,963,2881,1293,1,641,330,2560,1128,0.631163708086785,0.49473684210526314,0.15803747534516766,0.14473684210526316
DJI_0367.JPG,197.jpg,khoa_neo,1512,1329,2336,1693,1,824,364,1924,1511,0.47435897435897434,0.662719298245614,0.20315581854043394,0.15964912280701754
DJI_0367.JPG,197.jpg,tru_su,577,1244,1102,1396,2,525,152,839,1320,0.20685404339250493,0.5789473684210527,0.1294378698224852,0.06666666666666667
DJI_0367.JPG,197.jpg,tru_su,3688,833,4056,1500,2,368,667,3872,1166,0.9546351084812623,0.5114035087719299,0.09072978303747535,0.29254385964912283
DJI_0367.JPG,197.jpg,tru_su,3567,1576,3928,2007,2,361,431,3747,1791,0.9238165680473372,0.7855263157894737,0.08900394477317554,0.18903508771929825
DJI_0367.JPG,197.jpg,tru_su,1686,974,1739,1262,2,53,288,1712,1118,0.42209072978303747,0.4903508771929825,0.013067061143984222,0.12631578947368421
DJI_0367.JPG,197.jpg,tru_su,1901,821,2058,1008,2,157,187,1979,914,0.4879191321499014,0.40087719298245617,0.038708086785009865,0.08201754385964913
DJI_0367.JPG,197.jpg,khoa_neo,171,1291,314,1364,1,143,73,242,1327,0.059664694280078895,0.5820175438596491,0.035256410256410256,0.032017543859649125
DJI_0368.JPG,198.jpg,khoa_neo,127,1315,297,1422,1,170,107,212,1368,0.05226824457593689,0.6,0.041913214990138066,0.04692982456140351
DJI_0368.JPG,198.jpg,khoa_neo,1931,784,2636,1156,1,705,372,2283,970,0.5628698224852071,0.42543859649122806,0.17381656804733728,0.1631578947368421
DJI_0368.JPG,198.jpg,khoa_neo,1170,1103,1990,1543,1,820,440,1580,1323,0.3895463510848126,0.5802631578947368,0.20216962524654833,0.19298245614035087
DJI_0368.JPG,198.jpg,tru_su,536,1166,1136,1386,2,600,220,836,1276,0.20611439842209073,0.5596491228070175,0.14792899408284024,0.09649122807017543
DJI_0368.JPG,198.jpg,tru_su,3559,687,4056,1355,2,497,668,3807,1021,0.9386094674556213,0.44780701754385965,0.122534516765286,0.2929824561403509
DJI_0368.JPG,198.jpg,tru_su,3541,1562,3835,1959,2,294,397,3688,1760,0.9092702169625246,0.7719298245614035,0.07248520710059171,0.17412280701754385
DJI_0368.JPG,198.jpg,khoa_neo,147,1252,346,1297,1,199,45,246,1274,0.060650887573964495,0.5587719298245614,0.04906311637080868,0.019736842105263157
DJI_0368.JPG,198.jpg,tru_su,1915,800,2059,929,2,144,129,1987,864,0.48989151873767256,0.37894736842105264,0.03550295857988166,0.056578947368421055
DJI_0369.JPG,199.jpg,khoa_neo,1661,699,2337,1030,1,676,331,1999,864,0.4928500986193294,0.37894736842105264,0.16666666666666666,0.14517543859649124
DJI_0369.JPG,199.jpg,khoa_neo,688,921,1565,1370,1,877,449,1126,1145,0.2776134122287968,0.5021929824561403,0.21622287968441814,0.1969298245614035
DJI_0369.JPG,199.jpg,khoa_neo,365,1190,543,1302,1,178,112,454,1246,0.11193293885601578,0.5464912280701755,0.04388560157790927,0.04912280701754386
DJI_0369.JPG,199.jpg,tru_su,761,1117,1286,1260,2,525,143,1023,1188,0.2522189349112426,0.5210526315789473,0.1294378698224852,0.06271929824561404
DJI_0369.JPG,199.jpg,tru_su,3331,586,4056,1284,2,725,698,3693,935,0.9105029585798816,0.4100877192982456,0.17874753451676528,0.306140350877193
DJI_0369.JPG,199.jpg,tru_su,3757,1643,4051,2066,2,294,423,3904,1854,0.9625246548323472,0.8131578947368421,0.07248520710059171,0.18552631578947368
DJI_0369.JPG,199.jpg,khoa_neo,380,1136,584,1217,1,204,81,482,1176,0.11883629191321499,0.5157894736842106,0.05029585798816568,0.035526315789473684
DJI_0370.JPG,200.jpg,khoa_neo,263,1198,445,1302,1,182,104,354,1250,0.08727810650887574,0.5482456140350878,0.04487179487179487,0.0456140350877193
DJI_0370.JPG,200.jpg,khoa_neo,1131,657,1858,1011,1,727,354,1494,834,0.3683431952662722,0.36578947368421055,0.1792406311637081,0.15526315789473685
DJI_0370.JPG,200.jpg,khoa_neo,16,888,949,1388,1,933,500,482,1138,0.11883629191321499,0.49912280701754386,0.23002958579881658,0.21929824561403508
DJI_0370.JPG,200.jpg,tru_su,699,1126,1209,1269,2,510,143,954,1197,0.23520710059171598,0.525,0.1257396449704142,0.06271929824561404
DJI_0370.JPG,200.jpg,tru_su,2755,539,4056,1312,2,1301,773,3405,925,0.8394970414201184,0.4057017543859649,0.3207593688362919,0.33903508771929824
DJI_0370.JPG,200.jpg,tru_su,3656,1654,4011,2111,2,355,457,3833,1882,0.9450197238658777,0.8254385964912281,0.08752465483234714,0.20043859649122808
DJI_0370.JPG,200.jpg,khoa_neo,291,1140,483,1222,1,192,82,387,1181,0.09541420118343195,0.5179824561403509,0.047337278106508875,0.035964912280701755
DJI_0371.JPG,201.jpg,khoa_neo,440,772,1140,1097,1,700,325,790,934,0.1947731755424063,0.40964912280701754,0.17258382642998027,0.1425438596491228
DJI_0371.JPG,201.jpg,tru_su,1923,655,4056,1439,2,2133,784,2989,1047,0.7369329388560157,0.45921052631578946,0.525887573964497,0.34385964912280703
DJI_0371.JPG,201.jpg,tru_su,3500,1676,3819,2148,2,319,472,3659,1912,0.902120315581854,0.8385964912280702,0.07864891518737673,0.20701754385964913
DJI_0372.JPG,202.jpg,tru_su,594,680,4056,1552,2,3462,872,2325,1116,0.5732248520710059,0.48947368421052634,0.8535502958579881,0.3824561403508772
DJI_0372.JPG,202.jpg,tru_su,3274,1682,3586,2186,2,312,504,3430,1934,0.8456607495069034,0.8482456140350877,0.07692307692307693,0.22105263157894736
DJI_0373.JPG,203.jpg,tru_su,34,412,2399,1277,2,2365,865,1216,844,0.29980276134122286,0.3701754385964912,0.5830867850098619,0.3793859649122807
DJI_0373.JPG,203.jpg,tru_su,2891,1647,3164,2126,2,273,479,3027,1886,0.746301775147929,0.8271929824561404,0.0673076923076923,0.2100877192982456
DJI_0374.JPG,204.jpg,tru_su,1,810,2390,1747,2,2389,937,1195,1278,0.29462524654832345,0.5605263157894737,0.5890039447731755,0.41096491228070176
DJI_0374.JPG,204.jpg,tru_su,2871,1715,3177,2232,2,306,517,3024,1973,0.7455621301775148,0.8653508771929824,0.07544378698224852,0.2267543859649123
DJI_0375.JPG,205.jpg,khoa_neo,1113,1196,1415,1419,1,302,223,1264,1307,0.3116370808678501,0.5732456140350877,0.07445759368836292,0.09780701754385965
DJI_0375.JPG,205.jpg,khoa_neo,559,1198,960,1566,1,401,368,759,1382,0.1871301775147929,0.606140350877193,0.09886587771203156,0.16140350877192983
DJI_0375.JPG,205.jpg,khoa_neo,1878,1027,2000,1106,1,122,79,1939,1066,0.4780571992110454,0.4675438596491228,0.03007889546351085,0.03464912280701754
DJI_0375.JPG,205.jpg,tru_su,1321,1441,3476,2280,2,2155,839,2398,1860,0.5912228796844181,0.8157894736842105,0.5313116370808678,0.36798245614035086
DJI_0375.JPG,205.jpg,tru_su,2069,1122,2471,1300,2,402,178,2270,1211,0.5596646942800789,0.531140350877193,0.09911242603550297,0.0780701754385965
DJI_0375.JPG,205.jpg,tru_su,3094,1197,3271,1518,2,177,321,3182,1357,0.784516765285996,0.5951754385964912,0.04363905325443787,0.14078947368421052
DJI_0375.JPG,205.jpg,khoa_neo,654,1885,852,2215,1,198,330,753,2050,0.1856508875739645,0.8991228070175439,0.04881656804733728,0.14473684210526316
DJI_0375.JPG,205.jpg,tru_su,3506,1132,3762,1271,2,256,139,3634,1201,0.895956607495069,0.5267543859649123,0.0631163708086785,0.06096491228070176
DJI_0376.JPG,206.jpg,khoa_neo,1907,919,2127,1239,1,220,320,2017,1079,0.4972879684418146,0.4732456140350877,0.054240631163708086,0.14035087719298245
DJI_0376.JPG,206.jpg,tru_su,2413,1636,3449,2280,2,1036,644,2931,1958,0.7226331360946746,0.8587719298245614,0.25542406311637084,0.2824561403508772
DJI_0376.JPG,206.jpg,tru_su,3162,510,3589,813,2,427,303,3375,661,0.8321005917159763,0.2899122807017544,0.10527613412228796,0.13289473684210526
DJI_0376.JPG,206.jpg,khoa_neo,1741,1013,1865,1276,1,124,263,1803,1144,0.44452662721893493,0.5017543859649123,0.03057199211045365,0.11535087719298245
DJI_0376.JPG,206.jpg,khoa_neo,1869,1004,2011,1329,1,142,325,1940,1166,0.47830374753451677,0.5114035087719299,0.035009861932938854,0.1425438596491228
DJI_0376.JPG,206.jpg,khoa_neo,2922,378,3053,539,1,131,161,2987,458,0.736439842209073,0.20087719298245615,0.03229783037475345,0.0706140350877193
DJI_0376.JPG,206.jpg,khoa_neo,3000,324,3152,442,1,152,118,3076,383,0.7583826429980276,0.16798245614035087,0.03747534516765286,0.05175438596491228
DJI_0377.JPG,207.jpg,khoa_neo,1912,1007,2133,1329,1,221,322,2022,1168,0.4985207100591716,0.512280701754386,0.05448717948717949,0.1412280701754386
DJI_0377.JPG,207.jpg,khoa_neo,1785,1046,1953,1308,1,168,262,1869,1177,0.46079881656804733,0.5162280701754386,0.04142011834319527,0.11491228070175438
DJI_0377.JPG,207.jpg,khoa_neo,3058,358,3159,453,1,101,95,3108,405,0.7662721893491125,0.17763157894736842,0.02490138067061144,0.041666666666666664
DJI_0377.JPG,207.jpg,tru_su,3296,488,3778,796,2,482,308,3537,642,0.8720414201183432,0.28157894736842104,0.11883629191321499,0.13508771929824562
DJI_0377.JPG,207.jpg,tru_su,2698,1905,3750,2280,2,1052,375,3224,2092,0.7948717948717948,0.9175438596491228,0.2593688362919132,0.16447368421052633
DJI_0377.JPG,207.jpg,khoa_neo,2023,979,2281,1318,1,258,339,2152,1148,0.5305719921104537,0.5035087719298246,0.06360946745562131,0.14868421052631578
DJI_0377.JPG,207.jpg,khoa_neo,2500,1065,2935,1514,1,435,449,2717,1289,0.6698717948717948,0.5653508771929825,0.10724852071005918,0.1969298245614035
DJI_0377.JPG,207.jpg,khoa_neo,3126,308,3230,397,1,104,89,3178,352,0.7835305719921104,0.1543859649122807,0.02564102564102564,0.03903508771929825
DJI_0378.JPG,208.jpg,khoa_neo,2223,985,2356,1309,1,133,324,2289,1147,0.5643491124260355,0.5030701754385964,0.03279092702169625,0.14210526315789473
DJI_0378.JPG,208.jpg,khoa_neo,2083,985,2179,1181,1,96,196,2131,1083,0.5253944773175543,0.475,0.023668639053254437,0.08596491228070176
DJI_0378.JPG,208.jpg,khoa_neo,3551,478,3673,579,1,122,101,3612,528,0.8905325443786982,0.23157894736842105,0.03007889546351085,0.04429824561403509
DJI_0378.JPG,208.jpg,tru_su,3781,655,4056,940,2,275,285,3918,797,0.9659763313609467,0.3495614035087719,0.06780078895463511,0.125
DJI_0378.JPG,208.jpg,tru_su,2292,1989,3315,2280,2,1023,291,2803,2134,0.6910749506903353,0.9359649122807018,0.2522189349112426,0.12763157894736843
DJI_0378.JPG,208.jpg,khoa_neo,3624,429,3752,541,1,128,112,3688,485,0.9092702169625246,0.21271929824561403,0.03155818540433925,0.04912280701754386
DJI_0379.JPG,209.jpg,khoa_neo,2554,876,2718,1284,1,164,408,2636,1080,0.6499013806706114,0.47368421052631576,0.04043392504930966,0.17894736842105263
DJI_0379.JPG,209.jpg,khoa_neo,2399,886,2540,1201,1,141,315,2469,1043,0.6087278106508875,0.45745614035087717,0.03476331360946745,0.13815789473684212
DJI_0380.JPG,210.jpg,khoa_neo,3056,1227,3223,1542,1,167,315,3139,1384,0.7739151873767258,0.6070175438596491,0.04117357001972387,0.13815789473684212
DJI_0380.JPG,210.jpg,khoa_neo,3250,1271,3383,1666,1,133,395,3316,1468,0.8175542406311637,0.643859649122807,0.03279092702169625,0.17324561403508773
DJI_0380.JPG,210.jpg,khoa_neo,2600,1615,2858,2262,1,258,647,2729,1938,0.6728303747534516,0.85,0.06360946745562131,0.2837719298245614
DJI_0381.JPG,211.jpg,khoa_neo,2928,489,3102,834,1,174,345,3015,661,0.7433431952662722,0.2899122807017544,0.042899408284023666,0.1513157894736842
DJI_0381.JPG,211.jpg,khoa_neo,3060,593,3247,984,1,187,391,3153,788,0.7773668639053254,0.3456140350877193,0.04610453648915187,0.17149122807017544
DJI_0381.JPG,211.jpg,khoa_neo,2094,822,2460,1531,1,366,709,2277,1176,0.5613905325443787,0.5157894736842106,0.09023668639053255,0.3109649122807018
DJI_0381.JPG,211.jpg,khoa_neo,2462,1451,2761,2065,1,299,614,2611,1758,0.6437376725838264,0.7710526315789473,0.07371794871794872,0.2692982456140351
DJI_0381.JPG,211.jpg,tru_su,2678,2029,3006,2280,2,328,251,2842,2154,0.7006903353057199,0.9447368421052632,0.08086785009861933,0.11008771929824561
DJI_0382.JPG,212.jpg,khoa_neo,2867,460,3084,790,1,217,330,2975,625,0.7334812623274162,0.2741228070175439,0.05350098619329389,0.14473684210526316
DJI_0382.JPG,212.jpg,khoa_neo,2993,505,3225,968,1,232,463,3109,736,0.7665187376725838,0.32280701754385965,0.05719921104536489,0.20307017543859648
DJI_0382.JPG,212.jpg,khoa_neo,1727,756,2115,1427,1,388,671,1921,1091,0.47361932938856016,0.47850877192982455,0.09566074950690336,0.2942982456140351
DJI_0382.JPG,212.jpg,tru_su,2536,2063,2855,2280,2,319,217,2695,2171,0.664447731755424,0.9521929824561404,0.07864891518737673,0.09517543859649123
DJI_0382.JPG,212.jpg,khoa_neo,2023,1410,2377,2103,1,354,693,2200,1756,0.5424063116370809,0.7701754385964912,0.08727810650887574,0.30394736842105263
DJI_0383.JPG,213.jpg,khoa_neo,2970,614,3217,935,1,247,321,3093,774,0.7625739644970414,0.3394736842105263,0.060897435897435896,0.14078947368421052
DJI_0383.JPG,213.jpg,khoa_neo,3134,734,3395,1126,1,261,392,3264,930,0.8047337278106509,0.40789473684210525,0.0643491124260355,0.17192982456140352
DJI_0383.JPG,213.jpg,khoa_neo,1742,898,2142,1490,1,400,592,1942,1194,0.47879684418145957,0.5236842105263158,0.09861932938856016,0.2596491228070175
DJI_0383.JPG,213.jpg,khoa_neo,1969,1518,2298,2211,1,329,693,2133,1864,0.525887573964497,0.8175438596491228,0.08111439842209073,0.30394736842105263
DJI_0383.JPG,213.jpg,tru_su,2519,2124,2843,2280,2,324,156,2681,2202,0.6609960552268245,0.9657894736842105,0.07988165680473373,0.06842105263157895
DJI_0384.JPG,214.jpg,khoa_neo,1802,975,2211,1481,1,409,506,2006,1228,0.49457593688362916,0.5385964912280702,0.10083826429980276,0.2219298245614035
DJI_0384.JPG,214.jpg,khoa_neo,1973,1599,2323,2103,1,350,504,2148,1851,0.5295857988165681,0.8118421052631579,0.08629191321499013,0.22105263157894736
DJI_0384.JPG,214.jpg,khoa_neo,3120,720,3369,1032,1,249,312,3244,876,0.7998027613412229,0.38421052631578945,0.0613905325443787,0.1368421052631579
DJI_0384.JPG,214.jpg,khoa_neo,3259,818,3527,1180,1,268,362,3393,999,0.8365384615384616,0.4381578947368421,0.06607495069033531,0.1587719298245614
DJI_0385.JPG,215.jpg,khoa_neo,1974,680,2291,1123,1,317,443,2132,901,0.5256410256410257,0.39517543859649124,0.07815581854043392,0.19429824561403508
DJI_0385.JPG,215.jpg,khoa_neo,2124,1250,2388,1750,1,264,500,2256,1500,0.5562130177514792,0.6578947368421053,0.0650887573964497,0.21929824561403508
DJI_0385.JPG,215.jpg,khoa_neo,3152,630,3378,911,1,226,281,3265,770,0.8049802761341223,0.33771929824561403,0.05571992110453649,0.12324561403508771
DJI_0385.JPG,215.jpg,khoa_neo,3271,716,3518,1087,1,247,371,3394,901,0.8367850098619329,0.39517543859649124,0.060897435897435896,0.16271929824561404
DJI_0385.JPG,215.jpg,tru_su,2538,2071,2867,2280,2,329,209,2702,2175,0.6661735700197239,0.9539473684210527,0.08111439842209073,0.09166666666666666
DJI_0386.JPG,216.jpg,khoa_neo,2014,606,2473,1184,1,459,578,2243,895,0.553007889546351,0.3925438596491228,0.11316568047337278,0.2535087719298246
DJI_0386.JPG,216.jpg,khoa_neo,2015,1299,2458,1860,1,443,561,2236,1579,0.5512820512820513,0.6925438596491228,0.10922090729783038,0.24605263157894736
DJI_0386.JPG,216.jpg,khoa_neo,3329,741,3630,1052,1,301,311,3479,896,0.8577416173570019,0.3929824561403509,0.07421104536489152,0.13640350877192983
DJI_0386.JPG,216.jpg,khoa_neo,3462,909,3743,1233,1,281,324,3602,1071,0.8880670611439843,0.4697368421052632,0.06928007889546352,0.14210526315789473
DJI_0386.JPG,216.jpg,tru_su,2553,2170,2709,2280,2,156,110,2631,2225,0.6486686390532544,0.9758771929824561,0.038461538461538464,0.04824561403508772
DJI_0386.JPG,216.jpg,tru_su,879,2007,1306,2280,2,427,273,1092,2143,0.2692307692307692,0.9399122807017544,0.10527613412228796,0.11973684210526316
DJI_0387.JPG,217.jpg,khoa_neo,1898,654,2386,1164,1,488,510,2142,909,0.5281065088757396,0.3986842105263158,0.1203155818540434,0.2236842105263158
DJI_0387.JPG,217.jpg,khoa_neo,1961,1294,2391,1835,1,430,541,2176,1564,0.5364891518737672,0.6859649122807018,0.10601577909270217,0.23728070175438595
DJI_0387.JPG,217.jpg,khoa_neo,3387,816,3661,1084,1,274,268,3524,950,0.868836291913215,0.4166666666666667,0.0675542406311637,0.11754385964912281
DJI_0387.JPG,217.jpg,khoa_neo,3483,926,3798,1287,1,315,361,3640,1106,0.8974358974358975,0.4850877192982456,0.07766272189349112,0.15833333333333333
DJI_0387.JPG,217.jpg,tru_su,2573,2207,2693,2280,2,120,73,2633,2243,0.6491617357001972,0.9837719298245614,0.029585798816568046,0.032017543859649125
DJI_0388.JPG,218.jpg,khoa_neo,1786,770,2247,1189,1,461,419,2016,979,0.4970414201183432,0.4293859649122807,0.11365877712031558,0.1837719298245614
DJI_0388.JPG,218.jpg,khoa_neo,1761,1410,2215,1893,1,454,483,1988,1651,0.490138067061144,0.7241228070175438,0.11193293885601578,0.2118421052631579
DJI_0388.JPG,218.jpg,khoa_neo,3370,892,3646,1149,1,276,257,3508,1020,0.8648915187376726,0.4473684210526316,0.06804733727810651,0.11271929824561404
DJI_0388.JPG,218.jpg,khoa_neo,3459,1003,3781,1350,1,322,347,3620,1176,0.8925049309664694,0.5157894736842106,0.07938856015779093,0.15219298245614035
DJI_0389.JPG,219.jpg,khoa_neo,1749,761,2307,1238,1,558,477,2028,999,0.5,0.4381578947368421,0.13757396449704143,0.20921052631578949
DJI_0389.JPG,219.jpg,khoa_neo,1710,1443,2171,1906,1,461,463,1940,1674,0.47830374753451677,0.7342105263157894,0.11365877712031558,0.20307017543859648
DJI_0389.JPG,219.jpg,khoa_neo,3464,1026,3780,1277,1,316,251,3622,1151,0.8929980276134122,0.5048245614035087,0.07790927021696252,0.11008771929824561
DJI_0389.JPG,219.jpg,khoa_neo,3552,1155,3914,1477,1,362,322,3733,1316,0.9203648915187377,0.5771929824561404,0.08925049309664694,0.1412280701754386
DJI_0389.JPG,219.jpg,tru_su,220,1850,896,2280,2,676,430,558,2065,0.13757396449704143,0.9057017543859649,0.16666666666666666,0.18859649122807018
DJI_0390.JPG,220.jpg,khoa_neo,1669,804,2287,1302,1,618,498,1978,1053,0.48767258382643,0.4618421052631579,0.15236686390532544,0.21842105263157896
DJI_0390.JPG,220.jpg,khoa_neo,1519,1490,2119,2035,1,600,545,1819,1762,0.4484714003944773,0.7728070175438596,0.14792899408284024,0.23903508771929824
DJI_0390.JPG,220.jpg,khoa_neo,3566,1151,3899,1391,1,333,240,3732,1271,0.9201183431952663,0.5574561403508772,0.08210059171597633,0.10526315789473684
DJI_0390.JPG,220.jpg,khoa_neo,3626,1296,4026,1621,1,400,325,3826,1458,0.9432938856015779,0.6394736842105263,0.09861932938856016,0.1425438596491228
DJI_0390.JPG,220.jpg,tru_su,12,1793,761,2280,2,749,487,386,2036,0.09516765285996055,0.8929824561403509,0.1846646942800789,0.21359649122807017
DJI_0391.JPG,221.jpg,khoa_neo,1823,718,2565,1331,1,742,613,2194,1024,0.5409270216962525,0.44912280701754387,0.18293885601577908,0.268859649122807
DJI_0391.JPG,221.jpg,khoa_neo,1536,1509,2150,1985,1,614,476,1843,1747,0.45438856015779094,0.7662280701754386,0.15138067061143984,0.20877192982456141
DJI_0391.JPG,221.jpg,khoa_neo,3731,1624,4056,1823,1,325,199,3893,1723,0.9598126232741617,0.7557017543859649,0.08012820512820513,0.08728070175438596
DJI_0391.JPG,221.jpg,khoa_neo,3753,1850,4056,2074,1,303,224,3904,1962,0.9625246548323472,0.8605263157894737,0.07470414201183433,0.09824561403508772
DJI_0391.JPG,221.jpg,tru_su,10,1515,785,2280,2,775,765,397,1897,0.09787968441814596,0.8320175438596491,0.1910749506903353,0.3355263157894737
DJI_0392.JPG,222.jpg,khoa_neo,2339,1170,3130,1539,1,791,369,2734,1354,0.6740631163708086,0.593859649122807,0.1950197238658777,0.1618421052631579
DJI_0392.JPG,222.jpg,khoa_neo,1665,1552,2403,2078,1,738,526,2034,1815,0.5014792899408284,0.7960526315789473,0.1819526627218935,0.2307017543859649
DJI_0392.JPG,222.jpg,tru_su,1,791,1280,1666,2,1279,875,640,1228,0.15779092702169625,0.5385964912280702,0.3153353057199211,0.38377192982456143
DJI_0393.JPG,223.jpg,khoa_neo,2523,1431,3340,1835,1,817,404,2931,1633,0.7226331360946746,0.7162280701754385,0.20142998027613412,0.17719298245614035
DJI_0393.JPG,223.jpg,khoa_neo,1757,1585,2582,2023,1,825,438,2169,1804,0.5347633136094675,0.7912280701754386,0.20340236686390534,0.19210526315789472
DJI_0393.JPG,223.jpg,tru_su,7,223,1599,1474,2,1592,1251,803,848,0.19797830374753453,0.3719298245614035,0.39250493096646943,0.5486842105263158
DJI_0393.JPG,223.jpg,tru_su,902,1918,1173,2223,2,271,305,1037,2070,0.2556706114398422,0.9078947368421053,0.0668145956607495,0.1337719298245614
DJI_0394.JPG,224.jpg,khoa_neo,2561,1589,3336,2111,1,775,522,2948,1850,0.7268244575936884,0.8114035087719298,0.1910749506903353,0.22894736842105262
DJI_0394.JPG,224.jpg,khoa_neo,1932,1818,2611,2244,1,679,426,2271,2031,0.5599112426035503,0.8907894736842106,0.16740631163708086,0.1868421052631579
DJI_0394.JPG,224.jpg,tru_su,1,362,1684,1681,2,1683,1319,842,1021,0.20759368836291914,0.44780701754385965,0.41494082840236685,0.5785087719298245
DJI_0394.JPG,224.jpg,tru_su,977,2047,1227,2280,2,250,233,1102,2163,0.27169625246548323,0.9486842105263158,0.0616370808678501,0.10219298245614035
DJI_0395.JPG,225.jpg,tru_su,817,607,1215,1264,2,398,657,1016,935,0.2504930966469428,0.4100877192982456,0.09812623274161736,0.2881578947368421
DJI_0395.JPG,225.jpg,tru_su,1397,257,1487,618,2,90,361,1442,437,0.35552268244575935,0.19166666666666668,0.022189349112426034,0.15833333333333333
DJI_0395.JPG,225.jpg,tru_su,1091,1,1162,75,2,71,74,1126,38,0.2776134122287968,0.016666666666666666,0.017504930966469427,0.03245614035087719
DJI_0396.JPG,226.jpg,khoa_neo,2449,736,2761,927,1,312,191,2605,831,0.6422583826429981,0.36447368421052634,0.07692307692307693,0.0837719298245614
DJI_0396.JPG,226.jpg,khoa_neo,2236,1000,2609,1187,1,373,187,2422,1093,0.5971400394477318,0.4793859649122807,0.09196252465483234,0.08201754385964913
DJI_0396.JPG,226.jpg,khoa_neo,2708,569,2796,663,1,88,94,2752,616,0.6785009861932939,0.27017543859649124,0.021696252465483234,0.0412280701754386
DJI_0396.JPG,226.jpg,tru_su,255,804,757,1027,2,502,223,506,915,0.1247534516765286,0.40131578947368424,0.12376725838264299,0.09780701754385965
DJI_0396.JPG,226.jpg,tru_su,1949,1705,2577,2102,2,628,397,2263,1903,0.5579388560157791,0.8346491228070175,0.15483234714003946,0.17412280701754385
DJI_0396.JPG,226.jpg,tru_su,3151,1244,3404,1555,2,253,311,3277,1399,0.8079388560157791,0.6135964912280701,0.0623767258382643,0.13640350877192983
DJI_0396.JPG,226.jpg,tru_su,2858,1868,3144,2105,2,286,237,3001,1986,0.7398915187376726,0.8710526315789474,0.07051282051282051,0.10394736842105264
DJI_0396.JPG,226.jpg,tru_su,1158,428,1245,694,2,87,266,1201,561,0.29610453648915186,0.24605263157894736,0.021449704142011833,0.11666666666666667
DJI_0396.JPG,226.jpg,tru_su,1331,237,1475,428,2,144,191,1403,332,0.34590729783037477,0.1456140350877193,0.03550295857988166,0.0837719298245614
DJI_0396.JPG,226.jpg,khoa_neo,2833,588,2896,670,1,63,82,2864,629,0.7061143984220908,0.27587719298245617,0.015532544378698224,0.035964912280701755
DJI_0396.JPG,226.jpg,tru_su,3081,350,4056,984,2,975,634,3568,667,0.8796844181459567,0.29254385964912283,0.2403846153846154,0.27807017543859647
DJI_0397.JPG,227.jpg,khoa_neo,2205,800,2546,1008,1,341,208,2375,904,0.585552268244576,0.39649122807017545,0.08407297830374753,0.0912280701754386
DJI_0397.JPG,227.jpg,khoa_neo,1971,1067,2360,1261,1,389,194,2165,1164,0.5337771203155819,0.5105263157894737,0.09590729783037476,0.08508771929824561
DJI_0397.JPG,227.jpg,khoa_neo,2647,547,2743,723,1,96,176,2695,635,0.664447731755424,0.27850877192982454,0.023668639053254437,0.07719298245614035
DJI_0397.JPG,227.jpg,tru_su,187,825,691,1049,2,504,224,439,937,0.10823471400394477,0.41096491228070176,0.1242603550295858,0.09824561403508772
DJI_0397.JPG,227.jpg,tru_su,1842,1733,2479,2141,2,637,408,2160,1937,0.5325443786982249,0.849561403508772,0.15705128205128205,0.17894736842105263
DJI_0397.JPG,227.jpg,tru_su,2776,1882,3048,2127,2,272,245,2912,2004,0.717948717948718,0.8789473684210526,0.0670611439842209,0.1074561403508772
DJI_0397.JPG,227.jpg,tru_su,3076,1273,3321,1574,2,245,301,3198,1423,0.7884615384615384,0.6241228070175439,0.0604043392504931,0.13201754385964912
DJI_0397.JPG,227.jpg,tru_su,2949,377,4056,1031,2,1107,654,3502,704,0.8634122287968442,0.3087719298245614,0.2729289940828402,0.2868421052631579
DJI_0397.JPG,227.jpg,tru_su,1289,254,1424,434,2,135,180,1356,344,0.3343195266272189,0.15087719298245614,0.03328402366863906,0.07894736842105263
DJI_0397.JPG,227.jpg,tru_su,1108,452,1182,701,2,74,249,1145,576,0.2822978303747535,0.25263157894736843,0.01824457593688363,0.10921052631578948
DJI_0397.JPG,227.jpg,tru_su,2837,745,2947,936,2,110,191,2892,840,0.7130177514792899,0.3684210526315789,0.027120315581854043,0.0837719298245614
DJI_0398.JPG,228.jpg,khoa_neo,2063,944,2409,1121,1,346,177,2236,1032,0.5512820512820513,0.45263157894736844,0.08530571992110454,0.07763157894736843
DJI_0398.JPG,228.jpg,khoa_neo,1807,1226,2187,1396,1,380,170,1997,1311,0.4923570019723866,0.575,0.09368836291913216,0.07456140350877193
DJI_0398.JPG,228.jpg,khoa_neo,2603,635,2655,723,1,52,88,2629,679,0.6481755424063116,0.29780701754385963,0.01282051282051282,0.03859649122807018
DJI_0398.JPG,228.jpg,tru_su,150,878,659,1103,2,509,225,404,990,0.09960552268244575,0.4342105263157895,0.1254930966469428,0.09868421052631579
DJI_0398.JPG,228.jpg,tru_su,1065,503,1148,748,2,83,245,1106,625,0.27268244575936884,0.2741228070175439,0.020463510848126233,0.1074561403508772
DJI_0398.JPG,228.jpg,tru_su,1246,294,1385,494,2,139,200,1315,394,0.32421104536489154,0.17280701754385966,0.034270216962524656,0.08771929824561403
DJI_0398.JPG,228.jpg,tru_su,1752,1790,2411,2178,2,659,388,2081,1984,0.5130670611439843,0.8701754385964913,0.16247534516765286,0.17017543859649123
DJI_0398.JPG,228.jpg,tru_su,2997,1335,3235,1618,2,238,283,3116,1476,0.7682445759368837,0.6473684210526316,0.058678500986193295,0.12412280701754386
DJI_0398.JPG,228.jpg,tru_su,2700,1941,2949,2165,2,249,224,2824,2053,0.6962524654832347,0.900438596491228,0.0613905325443787,0.09824561403508772
DJI_0398.JPG,228.jpg,tru_su,2710,547,3856,1127,2,1146,580,3283,837,0.8094181459566075,0.3671052631578947,0.28254437869822485,0.2543859649122807
DJI_0399.JPG,229.jpg,khoa_neo,1840,1024,2194,1204,1,354,180,2017,1114,0.4972879684418146,0.4885964912280702,0.08727810650887574,0.07894736842105263
DJI_0399.JPG,229.jpg,khoa_neo,1548,1286,1972,1483,1,424,197,1760,1384,0.4339250493096647,0.6070175438596491,0.10453648915187377,0.08640350877192983
DJI_0399.JPG,229.jpg,tru_su,80,908,581,1135,2,501,227,330,1021,0.08136094674556213,0.44780701754385965,0.1235207100591716,0.09956140350877193
DJI_0399.JPG,229.jpg,tru_su,1180,324,1329,510,2,149,186,1254,417,0.3091715976331361,0.18289473684210528,0.03673570019723866,0.08157894736842106
DJI_0399.JPG,229.jpg,tru_su,1644,1820,2273,2224,2,629,404,1958,2022,0.482741617357002,0.8868421052631579,0.15507889546351084,0.17719298245614035
DJI_0399.JPG,229.jpg,tru_su,2590,1975,2830,2195,2,240,220,2710,2085,0.6681459566074951,0.9144736842105263,0.05917159763313609,0.09649122807017543
DJI_0399.JPG,229.jpg,tru_su,2912,1363,3137,1644,2,225,281,3024,1503,0.7455621301775148,0.6592105263157895,0.05547337278106509,0.12324561403508771
DJI_0399.JPG,229.jpg,tru_su,2498,550,3640,1256,2,1142,706,3069,903,0.7566568047337278,0.3960526315789474,0.28155818540433925,0.30964912280701756
DJI_0400.JPG,230.jpg,tru_su,2848,1369,3116,1681,2,268,312,2982,1525,0.735207100591716,0.668859649122807,0.06607495069033531,0.1368421052631579
DJI_0400.JPG,230.jpg,tru_su,30,921,542,1160,2,512,239,286,1040,0.07051282051282051,0.45614035087719296,0.126232741617357,0.10482456140350878
DJI_0400.JPG,230.jpg,tru_su,1618,1836,2254,2240,2,636,404,1936,2038,0.47731755424063116,0.893859649122807,0.15680473372781065,0.17719298245614035
DJI_0400.JPG,230.jpg,tru_su,2507,1997,2772,2236,2,265,239,2639,2116,0.6506410256410257,0.9280701754385965,0.0653353057199211,0.10482456140350878
DJI_0400.JPG,230.jpg,tru_su,2538,648,3519,1219,2,981,571,3028,933,0.7465483234714004,0.40921052631578947,0.24186390532544377,0.25043859649122807
DJI_0400.JPG,230.jpg,tru_su,1148,328,1293,481,2,145,153,1220,404,0.30078895463510846,0.17719298245614035,0.03574950690335306,0.06710526315789474
DJI_0400.JPG,230.jpg,khoa_neo,1485,1340,1911,1544,1,426,204,1698,1442,0.41863905325443784,0.6324561403508772,0.10502958579881656,0.08947368421052632
DJI_0400.JPG,230.jpg,khoa_neo,1737,1056,2090,1252,1,353,196,1913,1154,0.47164694280078895,0.506140350877193,0.08703155818540434,0.08596491228070176
DJI_0400.JPG,230.jpg,khoa_neo,2480,668,2542,764,1,62,96,2511,716,0.6190828402366864,0.3140350877192982,0.015285996055226824,0.042105263157894736
DJI_0401.JPG,231.jpg,tru_su,2383,694,3369,1211,2,986,517,2876,952,0.7090729783037475,0.41754385964912283,0.24309664694280078,0.2267543859649123
DJI_0401.JPG,231.jpg,tru_su,2797,1395,3022,1683,2,225,288,2909,1539,0.7172090729783037,0.675,0.05547337278106509,0.12631578947368421
DJI_0401.JPG,231.jpg,tru_su,1527,1845,2144,2241,2,617,396,1835,2043,0.45241617357001973,0.8960526315789473,0.15212031558185404,0.1736842105263158
DJI_0401.JPG,231.jpg,tru_su,1,918,481,1174,2,480,256,241,1046,0.05941814595660749,0.4587719298245614,0.11834319526627218,0.11228070175438597
DJI_0401.JPG,231.jpg,tru_su,1101,336,1251,494,2,150,158,1176,415,0.28994082840236685,0.18201754385964913,0.03698224852071006,0.06929824561403508
DJI_0401.JPG,231.jpg,khoa_neo,1330,1375,1718,1570,1,388,195,1524,1472,0.3757396449704142,0.6456140350877193,0.09566074950690336,0.08552631578947369
DJI_0401.JPG,231.jpg,khoa_neo,1572,1100,1978,1282,1,406,182,1775,1191,0.4376232741617357,0.5223684210526316,0.10009861932938856,0.07982456140350877
DJI_0401.JPG,231.jpg,khoa_neo,2439,702,2489,791,1,50,89,2464,746,0.6074950690335306,0.32719298245614037,0.01232741617357002,0.03903508771929825
DJI_0401.JPG,231.jpg,tru_su,2461,2018,2688,2248,2,227,230,2574,2133,0.6346153846153846,0.9355263157894737,0.05596646942800789,0.10087719298245613
DJI_0402.JPG,232.jpg,tru_su,2151,709,3171,1280,2,1020,571,2661,994,0.6560650887573964,0.4359649122807018,0.2514792899408284,0.25043859649122807
DJI_0402.JPG,232.jpg,tru_su,2707,1405,2933,1689,2,226,284,2820,1547,0.6952662721893491,0.6785087719298246,0.05571992110453649,0.12456140350877193
DJI_0402.JPG,232.jpg,tru_su,2369,2022,2588,2241,2,219,219,2478,2131,0.6109467455621301,0.9346491228070175,0.053994082840236685,0.09605263157894736
DJI_0402.JPG,232.jpg,tru_su,1418,1870,2047,2264,2,629,394,1732,2067,0.4270216962524655,0.906578947368421,0.15507889546351084,0.17280701754385966
DJI_0402.JPG,232.jpg,tru_su,5,942,410,1163,2,405,221,207,1052,0.05103550295857988,0.4614035087719298,0.09985207100591716,0.0969298245614035
DJI_0402.JPG,232.jpg,tru_su,1052,348,1190,500,2,138,152,1121,424,0.27638067061143984,0.18596491228070175,0.034023668639053255,0.06666666666666667
DJI_0402.JPG,232.jpg,khoa_neo,1130,1368,1565,1577,1,435,209,1347,1472,0.33210059171597633,0.6456140350877193,0.10724852071005918,0.09166666666666666
DJI_0402.JPG,232.jpg,khoa_neo,1405,1116,1780,1286,1,375,170,1592,1201,0.39250493096646943,0.5267543859649123,0.09245562130177515,0.07456140350877193
DJI_0402.JPG,232.jpg,khoa_neo,2360,691,2423,784,1,63,93,2391,737,0.5894970414201184,0.3232456140350877,0.015532544378698224,0.04078947368421053
DJI_0403.JPG,233.jpg,tru_su,2828,1393,3124,1720,2,296,327,2976,1556,0.7337278106508875,0.6824561403508772,0.07297830374753451,0.14342105263157895
DJI_0403.JPG,233.jpg,tru_su,1304,1952,2063,2280,2,759,328,1683,2116,0.41494082840236685,0.9280701754385965,0.1871301775147929,0.14385964912280702
DJI_0403.JPG,233.jpg,tru_su,2,876,180,1017,2,178,141,91,946,0.022435897435897436,0.4149122807017544,0.04388560157790927,0.06184210526315789
DJI_0403.JPG,233.jpg,tru_su,2281,361,3744,1200,2,1463,839,3012,780,0.742603550295858,0.34210526315789475,0.36070019723865876,0.36798245614035086
DJI_0403.JPG,233.jpg,tru_su,2488,2156,2715,2280,2,227,124,2601,2218,0.6412721893491125,0.9728070175438597,0.05596646942800789,0.054385964912280704
DJI_0403.JPG,233.jpg,khoa_neo,559,1369,1195,1658,1,636,289,877,1513,0.21622287968441814,0.6635964912280702,0.15680473372781065,0.1267543859649123
DJI_0403.JPG,233.jpg,khoa_neo,1064,943,1642,1173,1,578,230,1353,1058,0.33357988165680474,0.46403508771929824,0.14250493096646943,0.10087719298245613
DJI_0404.JPG,234.jpg,tru_su,3170,1454,3497,1796,2,327,342,3333,1625,0.8217455621301775,0.7127192982456141,0.08062130177514792,0.15
DJI_0404.JPG,234.jpg,tru_su,1500,1881,2284,2276,2,784,395,1892,2078,0.46646942800788954,0.9114035087719298,0.1932938856015779,0.17324561403508773
DJI_0404.JPG,234.jpg,tru_su,69,636,588,836,2,519,200,328,736,0.08086785009861933,0.32280701754385965,0.1279585798816568,0.08771929824561403
DJI_0404.JPG,234.jpg,tru_su,2683,259,4049,986,2,1366,727,3366,622,0.8298816568047337,0.27280701754385966,0.33678500986193294,0.318859649122807
DJI_0404.JPG,234.jpg,khoa_neo,865,980,1606,1264,1,741,284,1235,1122,0.30448717948717946,0.4921052631578947,0.18269230769230768,0.12456140350877193
DJI_0404.JPG,234.jpg,khoa_neo,1340,636,2019,931,1,679,295,1679,783,0.41395463510848124,0.34342105263157896,0.16740631163708086,0.12938596491228072
DJI_0404.JPG,234.jpg,tru_su,2936,868,3169,1114,2,233,246,3052,991,0.752465483234714,0.43464912280701756,0.057445759368836294,0.10789473684210527
DJI_0404.JPG,234.jpg,tru_su,2727,2153,3082,2280,2,355,127,2904,2216,0.7159763313609467,0.9719298245614035,0.08752465483234714,0.05570175438596491
DJI_0405.JPG,235.jpg,tru_su,1573,1847,2319,2278,2,746,431,1946,2062,0.4797830374753452,0.9043859649122807,0.1839250493096647,0.18903508771929825
DJI_0405.JPG,235.jpg,tru_su,3140,1435,3527,1797,2,387,362,3333,1616,0.8217455621301775,0.7087719298245614,0.09541420118343195,0.1587719298245614
DJI_0405.JPG,235.jpg,tru_su,53,603,603,810,2,550,207,328,706,0.08086785009861933,0.30964912280701756,0.13560157790927022,0.09078947368421053
DJI_0405.JPG,235.jpg,tru_su,2706,202,4056,986,2,1350,784,3381,594,0.8335798816568047,0.26052631578947366,0.3328402366863905,0.34385964912280703
DJI_0405.JPG,235.jpg,khoa_neo,752,914,1738,1310,1,986,396,1245,1112,0.3069526627218935,0.48771929824561405,0.24309664694280078,0.1736842105263158
DJI_0405.JPG,235.jpg,khoa_neo,1424,590,2019,889,1,595,299,1721,739,0.42430966469428005,0.32412280701754387,0.14669625246548323,0.13114035087719297
DJI_0405.JPG,235.jpg,tru_su,2935,886,3199,1102,2,264,216,3067,994,0.756163708086785,0.4359649122807018,0.0650887573964497,0.09473684210526316
DJI_0405.JPG,235.jpg,tru_su,2779,2159,3019,2277,2,240,118,2899,2218,0.7147435897435898,0.9728070175438597,0.05917159763313609,0.05175438596491228
DJI_0406.JPG,236.jpg,tru_su,1569,1902,2332,2280,2,763,378,1950,2091,0.4807692307692308,0.9171052631578948,0.1881163708086785,0.16578947368421051
DJI_0406.JPG,236.jpg,tru_su,3119,1510,3527,1835,2,408,325,3323,1672,0.8192800788954635,0.7333333333333333,0.10059171597633136,0.1425438596491228
DJI_0406.JPG,236.jpg,tru_su,123,681,644,864,2,521,183,383,772,0.09442800788954635,0.3385964912280702,0.1284516765285996,0.08026315789473684
DJI_0406.JPG,236.jpg,tru_su,2702,413,4056,1177,2,1354,764,3379,795,0.8330867850098619,0.34868421052631576,0.3338264299802761,0.3350877192982456
DJI_0406.JPG,236.jpg,khoa_neo,873,1180,1752,1509,1,879,329,1312,1344,0.3234714003944773,0.5894736842105263,0.21671597633136094,0.1442982456140351
DJI_0406.JPG,236.jpg,khoa_neo,1348,806,2011,1082,1,663,276,1679,944,0.41395463510848124,0.41403508771929826,0.16346153846153846,0.12105263157894737
DJI_0407.JPG,237.jpg,tru_su,77,710,619,902,2,542,192,348,806,0.08579881656804733,0.35350877192982455,0.133629191321499,0.08421052631578947
DJI_0407.JPG,237.jpg,tru_su,2644,527,4056,1231,2,1412,704,3350,879,0.8259368836291914,0.38552631578947366,0.34812623274161736,0.3087719298245614
DJI_0407.JPG,237.jpg,tru_su,3119,1498,3511,1860,2,392,362,3315,1679,0.8173076923076923,0.7364035087719298,0.09664694280078895,0.1587719298245614
DJI_0407.JPG,237.jpg,tru_su,1532,1972,2293,2280,2,761,308,1912,2126,0.4714003944773176,0.9324561403508772,0.1876232741617357,0.13508771929824562
DJI_0407.JPG,237.jpg,khoa_neo,854,1239,1649,1539,1,795,300,1251,1389,0.3084319526627219,0.6092105263157894,0.19600591715976332,0.13157894736842105
DJI_0407.JPG,237.jpg,khoa_neo,1361,877,1957,1164,1,596,287,1659,1020,0.40902366863905326,0.4473684210526316,0.14694280078895464,0.12587719298245614
DJI_0408.JPG,238.jpg,tru_su,273,410,1665,835,2,1392,425,969,622,0.23890532544378698,0.27280701754385966,0.3431952662721893,0.18640350877192982
DJI_0408.JPG,238.jpg,tru_su,2394,647,2894,1560,2,500,913,2644,1103,0.6518737672583826,0.4837719298245614,0.1232741617357002,0.4004385964912281
DJI_0408.JPG,238.jpg,tru_su,2998,381,3427,1118,2,429,737,3212,749,0.7919132149901381,0.3285087719298246,0.10576923076923077,0.3232456140350877
DJI_0408.JPG,238.jpg,tru_su,3148,1902,3527,2273,2,379,371,3337,2087,0.8227317554240631,0.9153508771929825,0.09344181459566075,0.16271929824561404
DJI_0408.JPG,238.jpg,tru_su,15,1289,148,1393,2,133,104,81,1341,0.019970414201183433,0.5881578947368421,0.03279092702169625,0.0456140350877193
DJI_0408.JPG,238.jpg,tru_su,846,883,1111,1054,2,265,171,978,968,0.2411242603550296,0.4245614035087719,0.0653353057199211,0.075
DJI_0408.JPG,238.jpg,tru_su,2526,59,2893,194,2,367,135,2709,126,0.6678994082840237,0.05526315789473684,0.09048323471400395,0.05921052631578947
DJI_0408.JPG,238.jpg,khoa_neo,3031,1638,3153,1801,1,122,163,3092,1719,0.76232741617357,0.7539473684210526,0.03007889546351085,0.07149122807017544
DJI_0408.JPG,238.jpg,khoa_neo,3175,1686,3274,1828,1,99,142,3224,1757,0.7948717948717948,0.7706140350877193,0.02440828402366864,0.062280701754385964
DJI_0409.JPG,239.jpg,tru_su,2015,437,2420,1387,2,405,950,2217,912,0.5465976331360947,0.4,0.09985207100591716,0.4166666666666667
DJI_0409.JPG,239.jpg,tru_su,2552,156,2936,918,2,384,762,2744,537,0.6765285996055227,0.2355263157894737,0.09467455621301775,0.33421052631578946
DJI_0409.JPG,239.jpg,tru_su,2727,1706,3169,2169,2,442,463,2948,1937,0.7268244575936884,0.849561403508772,0.10897435897435898,0.20307017543859648
DJI_0409.JPG,239.jpg,tru_su,19,218,1140,647,2,1121,429,579,432,0.14275147928994084,0.18947368421052632,0.27638067061143984,0.1881578947368421
DJI_0409.JPG,239.jpg,tru_su,352,880,607,1042,2,255,162,479,961,0.1180966469428008,0.4214912280701754,0.0628698224852071,0.07105263157894737
DJI_0409.JPG,239.jpg,khoa_neo,2610,1483,2718,1702,1,108,219,2664,1592,0.6568047337278107,0.6982456140350877,0.026627218934911243,0.09605263157894736
DJI_0409.JPG,239.jpg,khoa_neo,2744,1492,2851,1676,1,107,184,2797,1584,0.689595660749507,0.6947368421052632,0.02638067061143984,0.08070175438596491
DJI_0410.JPG,240.jpg,tru_su,2,285,1044,722,2,1042,437,523,503,0.1289447731755424,0.2206140350877193,0.2569033530571992,0.19166666666666668
DJI_0410.JPG,240.jpg,tru_su,1890,497,2298,1389,2,408,892,2094,943,0.5162721893491125,0.4135964912280702,0.10059171597633136,0.3912280701754386
DJI_0410.JPG,240.jpg,tru_su,2415,222,2786,989,2,371,767,2600,605,0.6410256410256411,0.26535087719298245,0.09146942800788954,0.3364035087719298
DJI_0410.JPG,240.jpg,tru_su,2627,1706,3061,2173,2,434,467,2844,1939,0.7011834319526628,0.8504385964912281,0.10700197238658778,0.20482456140350877
DJI_0410.JPG,240.jpg,tru_su,198,914,482,1102,2,284,188,340,1008,0.08382642998027613,0.4421052631578947,0.07001972386587771,0.0824561403508772
DJI_0410.JPG,240.jpg,khoa_neo,2535,1493,2613,1650,1,78,157,2574,1571,0.6346153846153846,0.6890350877192982,0.019230769230769232,0.06885964912280702
DJI_0410.JPG,240.jpg,khoa_neo,2655,1532,2742,1656,1,87,124,2698,1594,0.6651873767258383,0.6991228070175438,0.021449704142011833,0.054385964912280704
DJI_0411.JPG,241.jpg,tru_su,7,614,1019,964,2,1012,350,513,789,0.1264792899408284,0.3460526315789474,0.2495069033530572,0.15350877192982457
DJI_0411.JPG,241.jpg,tru_su,1902,777,2315,1727,2,413,950,2108,1252,0.519723865877712,0.5491228070175439,0.10182445759368837,0.4166666666666667
DJI_0411.JPG,241.jpg,tru_su,2490,647,2777,1377,2,287,730,2633,1012,0.6491617357001972,0.443859649122807,0.07075936883629191,0.3201754385964912
DJI_0411.JPG,241.jpg,tru_su,152,1527,419,1702,2,267,175,285,1614,0.07026627218934911,0.7078947368421052,0.06582840236686391,0.07675438596491228
DJI_0411.JPG,241.jpg,khoa_neo,2567,2062,2700,2274,1,133,212,2633,2168,0.6491617357001972,0.9508771929824561,0.03279092702169625,0.09298245614035087
DJI_0411.JPG,241.jpg,khoa_neo,2720,2127,2825,2276,1,105,149,2772,2201,0.6834319526627219,0.9653508771929824,0.025887573964497042,0.06535087719298245
DJI_0412.JPG,242.jpg,tru_su,1873,847,2273,1881,2,400,1034,2073,1364,0.511094674556213,0.5982456140350877,0.09861932938856016,0.4535087719298246
DJI_0412.JPG,242.jpg,tru_su,2481,856,2747,1648,2,266,792,2614,1252,0.6444773175542406,0.5491228070175439,0.0655818540433925,0.3473684210526316
DJI_0412.JPG,242.jpg,tru_su,10,713,1045,960,2,1035,247,527,836,0.129930966469428,0.36666666666666664,0.2551775147928994,0.10833333333333334
DJI_0412.JPG,242.jpg,tru_su,72,2046,359,2215,2,287,169,215,2130,0.053007889546351085,0.9342105263157895,0.07075936883629191,0.07412280701754385
DJI_0412.JPG,242.jpg,tru_su,1,987,59,1268,2,58,281,30,1127,0.0073964497041420114,0.49429824561403507,0.014299802761341223,0.12324561403508771
DJI_0412.JPG,242.jpg,tru_su,1892,857,2194,1002,2,302,145,2043,929,0.503698224852071,0.4074561403508772,0.07445759368836292,0.06359649122807018
DJI_0413.JPG,243.jpg,tru_su,19,360,982,614,2,963,254,500,487,0.1232741617357002,0.21359649122807017,0.23742603550295857,0.11140350877192982
DJI_0413.JPG,243.jpg,tru_su,1894,464,2298,1522,2,404,1058,2096,993,0.5167652859960552,0.4355263157894737,0.09960552268244575,0.46403508771929824
DJI_0413.JPG,243.jpg,tru_su,2473,635,2773,1414,2,300,779,2623,1024,0.6466962524654832,0.44912280701754387,0.07396449704142012,0.3416666666666667
DJI_0413.JPG,243.jpg,tru_su,283,773,624,925,2,341,152,453,849,0.11168639053254438,0.37236842105263157,0.08407297830374753,0.06666666666666667
DJI_0413.JPG,243.jpg,tru_su,1,821,68,1093,2,67,272,34,957,0.008382642998027613,0.41973684210526313,0.016518737672583828,0.11929824561403508
DJI_0413.JPG,243.jpg,tru_su,1898,656,2132,860,2,234,204,2015,758,0.4967948717948718,0.33245614035087717,0.057692307692307696,0.08947368421052632
DJI_0414.JPG,244.jpg,tru_su,15,431,1198,639,2,1183,208,606,535,0.14940828402366865,0.23464912280701755,0.2916666666666667,0.0912280701754386
DJI_0414.JPG,244.jpg,tru_su,2015,435,2440,1531,2,425,1096,2227,983,0.5490631163708086,0.431140350877193,0.10478303747534516,0.4807017543859649
DJI_0414.JPG,244.jpg,tru_su,2710,602,3064,1427,2,354,825,2887,1014,0.7117850098619329,0.44473684210526315,0.08727810650887574,0.3618421052631579
DJI_0414.JPG,244.jpg,tru_su,393,839,514,1210,2,121,371,453,1024,0.11168639053254438,0.44912280701754387,0.029832347140039447,0.16271929824561404
DJI_0414.JPG,244.jpg,tru_su,2198,647,2494,885,2,296,238,2346,766,0.5784023668639053,0.33596491228070174,0.07297830374753451,0.10438596491228071
DJI_0414.JPG,244.jpg,tru_su,677,756,1019,947,2,342,191,848,851,0.20907297830374755,0.3732456140350877,0.08431952662721894,0.0837719298245614
DJI_0414.JPG,244.jpg,tru_su,2198,652,2511,860,2,313,208,2354,756,0.5803747534516766,0.33157894736842103,0.07716962524654833,0.0912280701754386
DJI_0415.JPG,245.jpg,tru_su,2877,577,3177,1452,2,300,875,3027,1014,0.746301775147929,0.44473684210526315,0.07396449704142012,0.38377192982456143
DJI_0415.JPG,245.jpg,tru_su,2127,443,2515,1547,2,388,1104,2321,995,0.5722386587771203,0.43640350877192985,0.09566074950690336,0.4842105263157895
DJI_0415.JPG,245.jpg,tru_su,2523,656,2652,877,2,129,221,2587,766,0.6378205128205128,0.33596491228070174,0.031804733727810654,0.0969298245614035
DJI_0415.JPG,245.jpg,tru_su,1,418,1302,681,2,1301,263,651,549,0.16050295857988164,0.24078947368421053,0.3207593688362919,0.11535087719298245
DJI_0415.JPG,245.jpg,tru_su,619,835,736,1214,2,117,379,677,1024,0.16691321499013806,0.44912280701754387,0.028846153846153848,0.16622807017543859
DJI_0415.JPG,245.jpg,tru_su,977,793,1240,939,2,263,146,1108,866,0.27317554240631164,0.3798245614035088,0.0648422090729783,0.06403508771929825
DJI_0416.JPG,246.jpg,tru_su,1973,722,2323,931,2,350,209,2148,826,0.5295857988165681,0.362280701754386,0.08629191321499013,0.09166666666666666
DJI_0416.JPG,246.jpg,tru_su,2344,727,2636,1527,2,292,800,2490,1127,0.613905325443787,0.49429824561403507,0.07199211045364892,0.3508771929824561
DJI_0416.JPG,246.jpg,tru_su,1365,627,1744,1681,2,379,1054,1554,1154,0.3831360946745562,0.506140350877193,0.09344181459566075,0.46228070175438596
DJI_0416.JPG,246.jpg,tru_su,11,560,702,777,2,691,217,356,668,0.08777120315581854,0.2929824561403509,0.17036489151873768,0.09517543859649123
DJI_0416.JPG,246.jpg,tru_su,782,856,1111,968,2,329,112,946,912,0.23323471400394477,0.4,0.08111439842209073,0.04912280701754386
DJI_0417.JPG,247.jpg,tru_su,1,652,1148,914,2,1147,262,574,783,0.14151873767258383,0.34342105263157896,0.2827909270216962,0.11491228070175438
DJI_0417.JPG,247.jpg,tru_su,2444,773,2777,973,2,333,200,2610,873,0.643491124260355,0.3828947368421053,0.08210059171597633,0.08771929824561403
DJI_0417.JPG,247.jpg,tru_su,2840,739,3169,1606,2,329,867,3004,1172,0.7406311637080868,0.5140350877192983,0.08111439842209073,0.38026315789473686
DJI_0417.JPG,247.jpg,tru_su,1827,764,2194,1760,2,367,996,2010,1262,0.49556213017751477,0.5535087719298246,0.09048323471400395,0.4368421052631579
DJI_0417.JPG,247.jpg,tru_su,7,2157,261,2261,2,254,104,134,2209,0.033037475345167655,0.968859649122807,0.0626232741617357,0.0456140350877193
DJI_0417.JPG,247.jpg,tru_su,1286,897,1540,985,2,254,88,1413,941,0.34837278106508873,0.41271929824561404,0.0626232741617357,0.03859649122807018
DJI_0418.JPG,248.jpg,tru_su,136,685,1390,931,2,1254,246,763,808,0.1881163708086785,0.3543859649122807,0.3091715976331361,0.10789473684210527
DJI_0418.JPG,248.jpg,tru_su,15,2107,490,2240,2,475,133,252,2173,0.0621301775147929,0.9530701754385965,0.11711045364891519,0.058333333333333334
DJI_0418.JPG,248.jpg,tru_su,2640,764,2965,985,2,325,221,2802,874,0.6908284023668639,0.38333333333333336,0.08012820512820513,0.0969298245614035
DJI_0418.JPG,248.jpg,tru_su,3040,743,3402,1631,2,362,888,3221,1187,0.7941321499013807,0.5206140350877193,0.08925049309664694,0.3894736842105263
DJI_0418.JPG,248.jpg,tru_su,2044,706,2448,1781,2,404,1075,2246,1243,0.5537475345167653,0.5451754385964912,0.09960552268244575,0.47149122807017546
DJI_0418.JPG,248.jpg,tru_su,1127,939,1198,1327,2,71,388,1162,1133,0.2864891518737673,0.4969298245614035,0.017504930966469427,0.17017543859649123
